FE5 - Fields (Snow)
32 32
66 66 512 513 514 514 514 514 515 66 66 66 66 66 66 66 512 513 514 514 514 514 515 66 66 480 481 482 482 482 482 515
66 198 512 513 514 514 514 514 515 198 209 3 3 3 3 3 512 513 514 514 514 514 515 66 66 512 513 514 514 514 514 515
66 230 512 513 514 514 514 514 515 401 199 66 66 66 66 198 512 513 514 514 514 514 515 66 66 512 513 514 514 514 514 515
66 66 512 513 514 514 514 514 515 401 401 199 206 66 208 401 512 513 514 514 514 514 515 66 66 512 513 514 514 514 514 515
66 66 512 513 514 514 514 514 515 401 401 401 401 199 198 401 512 513 514 514 514 514 515 272 198 512 513 514 514 514 514 515
66 66 512 513 514 514 514 514 515 401 401 247 246 401 401 401 512 545 546 546 546 546 515 401 401 512 513 514 514 514 514 515
66 66 512 513 514 514 514 514 515 401 401 282 212 246 401 401 576 577 577 577 577 577 578 401 401 512 513 514 514 514 514 515
66 198 512 545 546 546 546 546 515 401 401 255 255 282 246 401 526 525 657 518 657 527 528 401 401 512 545 546 546 546 546 515
198 401 576 577 577 577 577 577 578 401 401 247 313 212 214 401 590 589 657 518 657 591 592 401 401 576 577 577 577 577 577 578
230 401 526 525 657 518 657 527 528 401 401 212 212 214 401 401 401 401 657 518 657 401 401 401 401 526 525 657 518 657 527 528
208 401 590 589 657 518 657 591 592 401 401 215 214 401 401 625 461 461 491 518 490 461 626 401 401 590 589 657 518 657 591 592
208 401 401 401 657 518 657 401 401 401 401 401 401 401 401 657 495 493 496 518 494 493 657 401 401 401 401 657 518 657 401 401
208 401 401 401 657 518 490 461 461 461 461 461 461 461 461 491 486 519 519 454 519 519 490 461 461 461 461 491 518 490 461 461
66 230 401 401 657 518 494 493 493 493 493 493 493 493 493 496 518 582 518 454 454 582 494 493 493 493 493 496 518 494 493 493
66 198 401 401 657 518 519 519 519 519 519 519 519 519 519 519 454 454 454 454 454 454 454 454 454 454 454 454 454 454 454 454
208 401 401 401 657 518 454 454 454 454 454 454 454 454 454 454 454 454 454 454 454 454 454 454 454 454 454 454 454 454 454 454
66 230 401 401 657 518 454 454 454 454 454 454 454 454 454 454 454 454 454 454 454 454 454 454 454 454 454 454 454 454 454 454
66 66 230 401 490 461 461 461 461 461 461 461 461 626 518 658 518 582 518 454 454 582 658 518 625 461 461 461 461 461 461 461
66 66 208 401 526 525 525 525 525 525 525 525 525 657 518 657 518 454 454 454 454 454 657 518 657 527 525 525 525 525 525 525
66 66 198 401 590 589 589 589 589 589 589 589 589 657 518 657 518 582 518 454 454 582 657 518 657 591 589 589 589 589 589 589
66 144 401 401 401 401 401 177 401 401 401 401 401 657 518 657 518 454 454 454 454 454 657 454 657 401 401 401 401 401 401 401
131 230 401 401 401 401 231 66 144 401 401 401 401 657 518 490 461 626 518 454 454 625 491 454 657 401 401 401 401 401 401 401
66 198 401 401 401 401 199 206 144 401 401 401 401 657 518 494 493 657 518 454 454 657 498 454 657 401 401 401 401 401 401 401
66 230 401 401 401 401 401 401 401 401 401 401 401 657 518 454 454 657 518 454 454 657 454 454 657 401 401 401 401 247 246 401
66 66 230 401 401 401 401 401 401 401 401 401 401 490 461 626 518 657 518 454 454 657 454 625 491 401 401 401 247 212 212 319
66 66 66 144 401 401 401 401 401 401 401 401 401 526 525 657 518 657 518 454 454 657 454 657 530 401 401 287 212 212 214 401
66 66 198 401 401 401 401 401 401 401 401 401 401 590 589 490 461 491 518 454 454 490 461 491 594 401 401 287 212 212 246 401
66 66 144 401 401 401 401 401 401 401 401 401 401 401 401 526 525 528 421 421 421 526 525 528 401 401 401 401 215 212 214 401
66 66 230 177 177 177 401 401 401 401 401 401 401 401 401 590 589 592 421 421 421 590 589 592 401 401 401 401 287 212 319 401
66 66 66 66 66 66 230 401 401 401 401 401 401 401 401 401 401 401 421 421 421 401 401 401 401 401 401 401 247 214 401 401
66 66 66 66 66 66 66 144 401 401 401 401 401 401 401 401 401 401 401 401 401 401 401 401 401 401 401 401 215 319 401 401
66 66 66 66 66 66 198 401 401 401 401 401 401 401 401 401 401 401 401 401 401 401 401 401 401 401 401 401 401 401 401 401
