FE5 - Fields (Day)
24 32
711 711 711 711 711 712 682 682 682 685 3 66 66 66 608 710 617 682 749 596 597 742 711 711 649 619 711 712 682 682 619 711
711 711 711 711 711 711 712 682 682 682 685 66 66 66 721 710 648 717 596 666 666 597 710 711 712 682 619 711 712 682 715 711
619 711 711 711 711 711 711 712 682 682 749 66 66 66 721 710 648 717 628 666 666 605 742 647 711 716 649 619 711 617 682 619
682 619 711 711 711 711 711 711 712 682 685 66 66 3 678 711 712 682 685 628 666 666 597 742 775 647 712 715 711 712 682 682
619 716 718 619 711 711 711 711 711 712 682 685 131 131 710 711 711 712 682 685 628 666 666 597 572 742 775 775 647 711 712 682
716 718 682 682 619 711 711 711 711 711 712 717 66 66 710 711 711 711 712 682 685 628 666 634 634 597 596 597 710 711 711 712
711 617 682 682 682 619 775 647 711 711 711 617 685 66 742 647 711 711 711 617 682 685 628 597 998 628 666 605 742 647 711 711
711 712 682 682 682 749 608 742 647 711 711 718 749 66 721 742 647 711 711 718 682 717 596 629 678 685 628 666 597 742 647 711
711 711 617 682 717 131 131 608 742 711 718 749 66 721 721 721 710 711 711 712 682 717 604 597 742 712 685 628 666 597 742 647
711 711 648 682 717 131 131 131 131 613 719 66 66 721 721 678 649 619 711 711 712 717 628 666 597 710 617 685 628 666 597 742
711 711 718 682 749 3 174 71 131 131 721 3 70 75 66 710 712 682 619 711 711 712 685 604 605 710 712 682 685 573 604 597
711 718 682 682 685 78 70 81 131 70 71 70 38 80 721 710 711 716 649 775 775 647 617 604 605 710 711 617 749 596 634 634
718 682 750 750 749 38 38 38 71 102 38 38 38 71 721 742 775 775 719 608 131 710 648 628 605 742 775 719 596 605 721 721
682 749 66 66 721 113 38 38 38 82 38 38 38 103 868 66 78 721 721 721 608 742 719 66 604 602 570 570 634 629 721 721
749 131 70 71 70 38 38 38 38 38 38 38 38 71 70 82 38 71 78 721 66 66 70 82 628 629 38 38 857 858 859 102
3 807 808 809 38 38 38 38 38 38 38 38 38 38 38 114 114 38 38 38 82 79 38 38 103 102 38 103 889 890 891 66
82 871 872 873 38 81 102 38 38 38 103 102 608 614 716 716 617 685 102 103 102 38 38 38 131 131 103 3 921 922 923 3
38 38 38 114 38 38 175 102 614 716 617 685 614 711 711 711 648 682 685 131 112 114 103 131 596 597 131 66 66 66 66 66
103 110 110 66 102 81 66 614 711 711 712 715 711 711 711 711 712 682 682 685 721 131 66 596 634 629 678 617 685 678 685 66
716 617 685 721 66 102 614 711 711 711 711 649 619 711 711 711 711 712 682 682 685 721 596 629 678 711 711 711 711 711 711 711
711 712 682 685 721 678 711 711 711 711 711 648 682 619 711 711 711 711 716 712 682 542 666 597 711 711 711 711 711 711 711 711
711 711 617 682 685 742 647 711 711 711 711 712 682 682 619 711 711 711 711 718 682 685 628 605 711 711 711 711 711 711 711 711
711 711 712 682 682 685 742 647 711 711 711 711 712 682 682 619 711 711 718 715 712 682 685 628 597 711 711 711 711 711 711 711
711 711 711 712 682 682 685 742 647 711 711 711 711 712 682 715 711 649 779 711 711 617 682 685 628 597 711 711 711 711 711 711
