FE5 - Castle v2 (Yellow)
32 32
37 35 35 35 96 32 32 65 135 71 37 37 167 37 35 35 104 167 96 32 32 32 65 135 135 135 64 32 32 32 32 32
37 35 338 33 35 138 32 32 32 97 35 35 35 35 406 405 35 35 96 32 32 32 32 32 32 32 32 32 338 32 32 32
37 35 371 395 398 398 398 398 398 398 398 398 398 398 398 398 398 398 398 398 398 398 398 398 398 398 398 398 371 32 32 32
406 405 362 781 782 782 782 846 846 846 846 846 846 846 846 846 846 846 846 846 846 846 846 846 782 782 782 782 362 32 32 32
135 64 362 813 750 750 814 878 878 878 878 148 323 398 398 398 398 398 329 149 878 878 878 878 814 750 750 814 362 32 32 32
32 32 362 813 750 750 814 878 878 148 323 398 393 515 516 516 516 517 387 398 329 149 878 878 814 750 750 814 362 32 32 32
32 32 362 813 814 814 814 878 148 323 393 516 517 579 580 580 580 581 515 516 387 329 149 878 814 814 814 814 362 32 32 32
32 97 387 329 877 878 878 148 323 393 517 580 581 556 845 846 846 556 579 580 515 387 329 149 877 878 878 323 393 32 32 32
32 109 515 362 877 878 878 185 394 517 581 845 150 282 282 282 282 282 149 846 579 515 394 186 877 878 878 362 517 32 32 97
32 65 547 362 877 878 878 184 611 581 845 878 184 323 398 823 395 329 184 846 846 579 612 184 877 878 878 362 549 32 97 35
32 32 579 362 877 878 878 216 643 845 878 878 184 362 845 855 845 362 184 878 846 846 644 216 877 878 878 362 581 97 35 148
96 556 32 362 877 878 878 878 846 878 878 878 184 362 877 878 878 362 184 878 878 878 846 878 877 878 878 362 1 556 33 153
35 96 32 362 877 878 878 152 330 877 878 878 184 394 822 877 822 394 184 878 878 878 330 152 877 878 878 362 33 35 822 153
4 35 167 362 877 878 878 184 387 329 877 878 182 151 848 847 848 150 183 878 878 323 393 184 877 878 878 362 33 35 35 153
4 35 323 393 877 878 878 184 515 387 329 877 878 182 283 878 281 183 878 878 323 393 517 184 877 878 878 387 329 33 35 153
4 405 362 877 878 878 878 184 579 515 362 877 878 878 878 878 878 878 878 878 362 517 581 184 878 878 878 878 362 33 35 153
4 35 362 877 878 878 878 182 151 579 387 398 329 877 878 822 877 878 323 398 393 581 150 183 878 878 878 878 362 33 822 153
4 35 362 877 878 878 878 878 182 151 515 516 387 338 877 848 847 338 393 516 517 150 183 878 878 878 878 878 362 33 35 153
35 35 362 877 878 878 878 878 878 184 579 580 515 370 877 878 878 370 517 580 581 184 878 878 878 878 878 878 362 33 35 153
35 35 362 877 878 878 878 878 878 182 212 149 579 402 877 878 878 402 581 148 213 183 878 878 878 878 878 878 362 33 35 153
35 35 362 813 814 814 814 878 878 878 180 311 149 434 878 878 878 434 148 311 181 878 878 878 814 814 814 814 362 33 35 153
406 405 362 813 750 750 814 878 878 878 878 180 311 212 212 212 212 212 311 181 878 878 878 878 814 750 750 814 362 33 822 153
35 35 362 813 750 750 814 878 878 878 878 878 180 244 244 244 244 244 181 878 878 878 878 878 814 750 750 814 362 33 35 153
35 35 338 813 814 814 814 878 878 878 878 878 878 878 878 878 878 878 878 878 878 878 878 878 814 814 814 814 338 33 35 153
35 35 371 395 398 338 877 878 878 878 878 878 878 338 877 878 878 338 877 878 878 878 878 878 878 338 395 398 371 33 35 153
35 35 403 548 548 371 395 398 398 398 398 398 398 371 425 458 459 371 395 398 398 398 398 398 398 371 516 516 403 33 35 153
35 35 403 548 548 403 548 548 548 548 548 548 548 403 425 458 459 403 516 516 516 516 516 516 516 403 548 548 403 33 35 153
35 35 435 580 580 403 548 548 548 548 548 548 548 403 425 458 459 403 548 548 548 548 548 548 548 403 580 580 435 33 822 153
35 35 35 35 35 435 580 580 580 580 580 580 580 403 425 458 459 403 580 580 580 580 580 580 580 435 35 35 35 33 35 153
35 35 35 35 35 35 35 35 35 35 35 35 35 435 425 458 459 435 35 35 35 35 35 35 35 35 35 406 405 35 35 153
35 35 35 35 822 35 35 35 35 35 35 35 35 35 457 458 459 35 35 35 35 35 35 35 35 35 35 35 35 35 35 153
212 212 212 212 212 212 212 212 212 212 149 35 35 35 35 35 35 35 35 35 35 35 212 212 212 212 212 212 212 212 212 276
