FE5 - Castle v2 (Purple)
32 32
689 689 689 689 689 689 689 689 689 689 689 689 689 689 689 689 689 689 689 689 689 689 689 689 689 689 689 689 689 689 689 689
689 689 689 689 689 689 689 689 689 689 689 689 323 398 398 823 398 398 329 689 689 689 689 689 689 689 689 689 689 689 689 689
689 689 689 689 689 689 689 689 689 689 689 689 362 845 983 855 979 846 362 689 689 689 689 689 689 689 689 689 689 689 689 689
689 689 689 689 689 689 689 689 689 689 689 689 362 877 983 983 983 878 362 689 689 689 689 689 689 689 689 689 689 689 689 689
689 689 689 689 689 689 689 689 689 689 689 689 387 398 399 428 396 398 393 689 689 689 689 689 689 689 689 689 689 689 689 689
689 689 689 689 689 689 689 689 689 689 323 398 515 516 517 428 515 516 517 398 329 689 689 689 689 689 689 689 689 689 689 689
339 689 689 398 398 398 689 689 339 689 362 845 547 548 549 428 547 548 549 845 362 689 339 689 689 689 398 398 398 689 689 339
371 689 689 983 983 983 689 689 371 689 362 877 579 580 581 428 579 580 581 877 362 689 371 689 689 689 983 983 983 689 689 371
403 689 689 983 556 979 689 689 403 689 362 877 822 822 822 428 822 822 822 877 362 689 403 689 689 689 983 556 979 689 689 403
435 689 689 983 983 983 689 689 435 689 362 877 848 848 854 983 854 848 848 878 362 689 435 689 689 689 983 983 983 689 689 435
689 689 689 398 398 398 689 689 689 689 362 877 878 878 983 983 983 878 878 878 362 689 689 689 689 689 398 398 398 689 689 689
689 689 689 515 516 517 689 689 689 689 387 398 398 399 983 983 983 396 398 398 393 689 689 689 689 689 515 516 517 689 689 689
689 689 689 579 580 581 689 689 689 689 515 516 516 517 457 458 459 515 516 516 517 689 689 689 689 689 579 580 581 689 689 689
339 689 689 689 689 689 689 689 339 689 579 580 611 549 457 458 459 547 612 580 549 689 339 689 689 689 689 689 689 689 689 339
371 689 689 689 689 689 689 689 371 689 323 398 643 581 457 458 459 579 644 398 329 689 371 689 689 689 689 689 689 689 689 371
403 689 689 689 689 689 689 689 403 689 362 877 822 689 457 458 459 689 822 877 362 689 403 689 689 689 689 689 689 689 689 403
435 689 689 689 689 689 689 689 435 689 362 877 822 689 457 458 459 689 822 877 362 689 435 689 689 689 689 689 689 689 689 435
689 689 689 689 689 689 689 689 689 689 362 877 822 689 457 458 459 689 822 877 362 689 689 689 689 689 689 689 689 689 689 689
398 398 398 398 398 398 398 398 398 398 393 877 822 689 457 458 459 689 822 877 387 398 398 398 398 398 398 398 398 398 398 398
846 846 846 846 846 846 846 846 846 846 846 878 822 877 457 458 459 878 822 877 846 846 846 846 846 846 846 846 846 846 846 846
398 398 324 398 398 398 398 324 398 398 329 877 848 847 457 458 459 878 848 847 323 398 398 324 398 398 398 398 324 398 398 398
516 516 362 979 983 983 983 362 516 516 362 877 878 983 983 983 983 983 878 878 362 516 516 362 979 983 983 983 362 516 516 516
580 580 387 398 398 398 398 393 580 580 362 877 878 983 983 983 983 983 878 878 362 580 580 387 398 398 398 398 393 580 580 580
689 339 515 516 516 516 516 517 339 689 362 877 878 983 983 983 983 983 878 878 362 689 339 515 516 516 516 516 517 339 689 689
689 371 579 580 580 580 580 581 371 689 387 329 877 983 323 398 329 979 878 323 393 689 371 579 580 580 580 580 581 371 689 689
689 403 689 689 689 689 689 689 403 689 684 362 877 983 362 979 362 979 878 362 683 689 403 689 689 689 689 689 689 403 689 689
689 435 689 689 689 689 689 689 435 689 748 362 877 983 362 979 362 979 878 362 747 689 435 689 689 689 689 689 689 435 689 689
689 689 689 689 689 689 689 689 689 689 689 362 877 983 362 979 362 979 878 362 689 689 689 689 689 689 689 689 689 689 689 689
689 689 689 689 323 398 398 398 398 398 398 393 877 983 387 398 393 979 878 387 398 398 398 398 398 398 329 689 689 689 689 689
689 689 689 323 393 845 846 846 846 846 846 846 878 983 983 983 983 983 846 846 846 846 846 846 846 846 387 329 689 689 689 689
689 339 689 362 845 878 658 659 878 878 878 878 878 983 983 983 983 983 878 878 878 878 878 658 659 878 878 362 689 339 689 689
689 371 689 362 877 878 690 691 878 878 878 878 878 983 983 983 983 983 878 878 878 878 878 690 691 878 878 362 689 371 689 689
