FE5 - Fields (Lava)
32 32
682 750 749 21 212 52 742 647 711 711 712 682 682 717 21 213 213 213 213 213 213 213 213 213 213 213 213 213 213 213 213 213
717 941 942 943 21 212 218 710 711 711 711 718 682 749 53 213 213 213 213 20 120 120 21 213 213 213 213 213 213 213 213 213
717 973 974 975 53 220 678 647 711 711 718 682 717 219 213 213 20 120 120 678 716 617 685 21 213 213 213 213 213 213 213 213
749 1005 1006 1007 21 212 52 710 711 718 682 682 682 685 21 20 614 716 716 711 711 712 682 685 21 213 213 213 213 213 213 213
193 869 193 193 193 193 193 193 711 193 193 193 193 193 869 869 869 193 193 193 193 193 193 193 193 193 869 213 213 213 213 213
257 869 257 257 257 212 212 257 257 257 257 257 869 20 225 224 226 648 717 21 212 54 742 711 712 682 529 213 213 213 213 213
711 529 617 685 21 212 212 212 212 52 119 53 529 614 225 224 226 718 717 53 212 212 54 742 711 712 593 21 213 213 213 213
711 711 648 682 685 21 212 245 212 212 212 20 561 711 225 224 226 682 717 221 20 120 21 54 742 711 648 685 21 213 213 213
711 711 718 682 717 53 276 213 245 212 20 678 593 711 225 224 226 682 717 21 218 678 681 21 54 742 712 682 685 21 213 213
711 711 712 682 717 21 212 276 213 245 52 742 647 711 711 224 226 682 749 53 52 710 712 685 21 54 742 712 682 685 21 213
619 711 711 712 682 685 21 212 276 212 212 218 742 647 711 224 226 717 219 212 20 710 711 681 685 21 54 742 712 682 685 21
682 619 711 711 712 682 685 120 120 21 212 117 52 742 225 224 226 717 219 212 218 710 711 712 682 685 21 54 742 712 682 685
712 682 619 711 711 712 715 617 685 219 212 212 212 52 225 711 226 717 219 212 52 742 647 711 712 682 685 21 54 742 712 682
711 649 779 711 711 711 716 718 749 53 244 245 212 20 225 711 226 617 685 21 212 218 710 711 711 712 682 685 21 54 742 712
711 718 715 711 711 711 718 749 53 244 213 213 245 52 225 711 226 718 717 219 212 218 710 711 711 711 712 682 685 21 54 119
718 682 779 711 711 718 717 219 212 276 213 213 277 212 225 224 226 682 682 685 21 52 710 711 711 711 711 718 682 685 21 212
682 715 716 711 712 682 682 685 21 212 276 277 212 212 225 224 617 682 682 749 53 20 710 711 711 711 718 750 750 749 53 212
682 619 711 711 711 712 682 682 685 21 212 212 212 212 225 224 712 682 717 219 212 52 742 647 711 718 717 219 54 53 212 212
716 617 619 711 711 711 712 682 682 685 21 212 212 212 225 224 619 712 717 219 212 212 218 710 711 617 749 53 212 212 212 244
711 648 682 619 711 711 711 712 682 682 685 21 212 212 225 224 226 619 617 685 21 212 218 742 775 719 53 212 212 212 244 213
711 718 682 619 711 711 711 711 712 682 682 685 21 212 869 869 869 750 719 749 53 212 52 119 119 53 212 212 212 244 213 213
711 712 682 715 711 711 711 711 718 682 682 682 685 21 421 421 421 52 119 53 212 212 212 212 212 212 212 244 213 213 213 213
711 711 712 619 711 711 711 718 682 682 682 682 749 219 421 421 421 212 212 212 212 212 212 212 212 212 244 213 213 213 213 213
619 711 711 716 711 711 718 682 682 682 682 749 119 53 421 421 421 212 212 212 212 212 212 212 212 212 276 213 213 213 213 213
682 619 711 711 711 718 682 682 682 682 749 53 212 212 421 421 421 212 212 212 212 212 212 212 212 212 212 213 213 213 213 213
682 715 711 711 718 715 712 715 617 682 685 21 212 212 421 421 421 625 458 458 458 458 458 626 212 212 212 212 276 213 213 213
682 619 711 711 712 779 711 716 718 682 682 685 21 87 421 421 421 657 486 519 519 519 519 657 21 212 212 212 212 276 213 213
712 682 619 711 711 716 711 718 682 682 682 750 654 625 421 421 421 554 518 454 454 454 454 657 219 84 85 86 212 212 276 213
711 649 619 711 711 711 718 682 682 682 749 119 53 657 486 519 519 454 454 454 454 454 454 522 626 868 868 868 21 87 212 276
711 711 649 619 711 718 682 682 682 749 53 212 212 657 518 454 454 454 454 454 454 454 454 454 554 518 454 454 457 458 458 626
711 711 718 715 712 682 682 682 749 53 212 212 220 657 518 454 454 454 454 454 454 454 454 454 454 454 454 454 519 519 519 657
711 718 715 716 711 712 682 749 53 212 212 212 20 490 461 461 461 461 461 461 461 461 461 461 461 461 461 461 461 461 461 491
