FE5 - Castle v2 (Purple)
32 32
1006 1006 1006 1006 362 979 362 451 452 453 453 453 453 453 453 453 453 453 453 453 453 453 453 453 453 454 362 979 362 1005 1006 1006
1006 1006 1006 1006 362 979 362 451 452 453 453 453 453 453 453 453 453 453 453 453 453 453 453 453 453 454 362 979 362 1005 1006 1006
1006 1006 1006 1006 362 979 362 451 484 485 485 485 485 485 485 485 485 485 485 485 485 485 485 485 485 454 362 979 362 1005 1006 1006
1006 1006 1006 1006 362 979 362 489 490 490 490 490 490 490 490 490 490 490 490 490 490 490 490 490 490 491 362 979 362 1005 1006 1006
1006 1006 1006 1006 362 979 387 398 400 398 398 398 398 398 398 398 398 398 398 398 398 398 398 398 400 398 393 979 362 1005 1006 1006
1006 1006 1006 1006 362 979 983 983 983 983 983 983 983 983 983 983 983 983 983 983 983 983 983 983 983 983 983 983 362 1005 1006 1006
1006 1006 1006 1006 387 398 398 398 398 398 398 398 398 398 329 979 983 983 323 398 398 398 398 398 398 398 398 398 393 1005 1006 1006
1006 1006 1006 1006 515 516 516 516 516 516 516 525 526 515 362 979 983 983 362 517 527 528 516 516 516 516 516 516 517 1005 1006 1006
1006 1006 1006 1006 579 580 580 580 580 580 580 557 558 579 362 979 983 983 362 581 559 560 580 580 580 580 580 580 581 1005 1006 1006
1006 1006 1006 1006 981 981 974 974 974 974 974 974 974 974 362 979 983 983 362 973 974 974 974 974 974 974 974 981 981 1006 1006 1006
1006 1006 1006 1006 981 981 323 398 398 398 398 398 398 398 393 979 983 983 387 398 398 398 398 398 398 398 329 981 981 1006 1006 1006
1006 1006 1006 1006 981 981 362 845 878 878 878 878 878 878 878 983 983 983 878 878 878 878 878 878 878 878 362 981 981 1006 1006 1006
1006 323 398 329 981 981 362 212 212 212 212 212 212 212 149 983 983 983 148 212 212 212 212 212 212 212 362 981 981 323 398 329
1006 362 689 362 981 981 362 244 244 244 244 244 244 244 181 983 983 983 180 244 244 244 244 244 244 244 362 981 981 362 689 362
1006 362 689 362 981 981 362 877 878 878 878 878 878 878 878 983 983 983 878 878 878 878 878 878 878 878 362 981 981 362 689 362
1006 387 398 393 981 981 387 398 398 398 398 398 398 398 398 425 458 459 398 398 398 398 398 398 398 398 393 981 981 387 398 393
1006 1006 1006 1006 981 981 515 516 516 516 525 526 527 528 611 425 458 459 612 525 526 527 528 516 516 516 517 981 981 1006 1006 1006
1006 1006 1006 1006 981 981 579 580 580 580 557 558 559 560 643 425 458 459 644 557 558 559 560 580 580 580 581 981 981 1006 1006 1006
1006 1006 1006 1006 981 981 974 974 974 974 974 974 974 974 974 974 981 974 974 974 974 974 974 974 974 974 974 981 981 1006 1006 1006
1006 1006 1006 1006 920 921 921 921 921 921 921 921 922 1006 1006 1006 981 1006 1006 1006 920 921 921 921 921 921 921 921 922 1006 1006 1006
1006 1006 1006 1006 1006 1006 1006 1006 1006 1006 1006 1006 1006 1006 1006 1006 981 1006 1006 1006 1006 1006 1006 1006 1006 1006 1006 1006 1006 1006 1006 1006
398 398 398 398 398 398 398 398 398 398 398 398 398 398 329 1005 981 1006 323 398 398 398 398 398 398 398 398 398 398 398 398 398
846 846 846 846 846 846 846 846 846 846 846 846 846 846 362 1005 981 1006 362 845 846 846 846 846 846 846 846 846 846 846 846 846
282 282 282 282 282 556 282 282 282 282 282 282 283 878 362 1005 981 1006 362 877 281 282 282 282 282 282 282 556 282 282 282 282
878 878 878 878 878 878 878 878 878 878 878 878 878 878 362 1005 981 1006 362 877 878 878 878 878 878 878 878 878 878 878 878 878
398 398 398 398 399 878 396 398 398 398 398 398 398 398 393 1005 981 1006 387 398 398 398 398 398 398 398 399 878 396 398 398 398
516 517 527 528 611 428 612 525 526 515 516 516 516 516 517 1005 981 1006 515 516 516 516 516 517 527 528 611 428 612 525 526 515
580 581 559 560 643 428 644 557 558 579 580 580 580 580 581 1005 981 1006 579 580 580 580 580 581 559 560 643 428 644 557 558 579
974 974 974 974 974 974 974 974 974 974 974 974 974 974 974 1006 981 1006 974 974 974 974 974 974 974 974 974 974 974 974 974 974
1006 1006 1006 1006 1006 1006 1006 1006 1006 1006 1006 1006 1006 1006 1006 1006 981 1006 1006 1006 1006 1006 1006 1006 1006 1006 1006 1006 1006 1006 1006 1006
1006 1006 1006 1006 1006 1006 1006 1006 1006 1006 1006 1006 1006 1006 1006 1006 981 1006 1006 1006 1006 1006 1006 1006 1006 1006 1006 1006 1006 1006 1006 1006
1006 1006 1006 1006 1006 1006 1006 1006 1006 1006 1006 1006 1006 1006 1006 1006 981 1006 1006 1006 1006 1006 1006 1006 1006 1006 1006 1006 1006 1006 1006 1006
