FE5 - Castle v2 (Yellow)
17 15
0 0 814 814 814 394 877 878 878 394 813 814 814 0 0
0 0 814 750 814 846 878 878 878 846 814 750 814 0 0
0 0 814 814 814 330 877 878 878 330 813 814 814 0 0
0 0 330 877 396 356 398 398 398 356 399 877 396 0 0
0 0 362 877 878 362 845 846 846 362 877 878 878 0 0
0 0 362 877 878 362 877 878 878 362 877 878 878 0 0
0 0 362 877 878 362 877 878 878 362 877 878 878 0 0
0 0 362 877 878 362 877 878 878 362 877 878 878 0 0
0 0 393 877 396 388 399 877 396 388 399 877 396 0 0
0 0 782 814 782 846 846 878 846 846 782 814 782 0 0
0 0 814 750 814 878 878 878 878 878 814 750 814 0 0
0 0 814 814 814 878 878 878 878 878 814 814 814 0 0
0 0 398 398 398 399 877 878 878 396 398 398 398 0 0
0 0 609 609 609 610 425 458 459 608 609 609 609 0 0
0 0 35 35 35 108 32 32 32 107 35 35 35 0 0
0 0 35 35 35 35 138 32 97 35 35 35 35 0 0
0 0 35 35 35 35 96 32 107 35 35 35 35 0 0
