FE5 - Fields (Green)
10 32
0 0 0 0 0 0 0 0 0 0 0 0 0 0 0 0 0 0 0 0 0 0 0 0 0 0 0 0 0 0 0 0
70 71 14 705 66 66 678 711 617 749 740 672 740 786 787 14 70 103 173 102 175 131 818 819 66 66 66 609 610 66 705 740
787 38 38 82 71 40 742 647 718 685 66 70 71 818 819 38 38 45 70 82 71 78 721 721 721 112 71 66 66 66 70 79
819 103 102 38 38 45 678 647 617 749 44 38 103 131 721 114 103 131 113 103 102 114 175 66 678 685 102 80 66 44 38 38
80 40 40 46 102 82 71 742 719 131 721 46 868 70 103 678 681 685 102 45 131 721 107 678 711 617 685 66 810 811 812 38
70 82 71 131 131 46 113 71 14 66 721 721 66 721 678 711 718 682 685 66 721 66 678 647 711 718 749 131 842 843 844 38
38 38 38 77 868 66 102 38 38 71 721 721 35 66 678 711 617 682 749 37 721 133 14 742 718 749 66 66 102 38 38 103
721 38 38 109 37 66 35 46 46 102 175 721 131 44 710 711 712 682 685 133 133 868 114 71 66 721 786 787 66 102 103 131
38 38 38 71 672 740 608 37 37 106 35 133 133 70 742 647 711 617 749 70 71 46 66 102 721 721 818 819 721 66 66 66
0 0 0 0 0 0 0 0 0 0 0 0 0 0 0 0 0 0 0 0 0 0 0 0 0 0 0 0 0 0 0 0
