FE5 - Fields (Green)
32 32
245 212 212 212 212 52 66 721 857 858 859 721 38 103 66 721 66 102 721 71 162 721 721 38 38 38 38 38 103 66 66 66
213 245 212 212 212 220 66 66 889 890 891 38 38 721 772 772 66 66 66 102 721 721 721 38 103 102 38 103 721 721 66 66
213 213 245 212 212 220 66 66 921 922 923 38 114 38 82 71 100 721 772 70 38 38 38 103 721 66 47 66 721 721 772 772
213 213 213 212 212 220 66 3 3 102 103 173 3 102 103 110 109 112 82 38 38 38 103 165 69 69 69 66 66 66 66 66
213 213 213 245 212 212 52 772 773 3 3 66 772 772 66 868 69 70 38 103 110 110 162 162 162 162 162 162 66 737 741 772
213 213 213 213 245 212 220 66 741 772 772 66 66 66 66 66 162 102 38 80 162 3 66 3 3 100 772 772 772 66 66 66
213 213 213 213 213 212 212 52 165 165 804 772 772 165 66 66 66 174 103 772 772 772 737 772 772 100 66 66 66 66 53 52
213 213 213 213 213 245 212 212 52 66 66 162 66 162 66 66 66 66 66 100 100 53 52 3 3 53 117 117 117 117 212 244
213 213 213 213 213 213 245 212 212 117 117 117 117 117 288 289 117 117 117 52 53 212 212 117 117 212 212 212 212 212 244 213
213 213 213 213 213 213 213 245 212 212 212 212 212 212 225 226 212 212 212 212 212 212 212 212 212 212 212 212 212 244 213 213
213 213 213 213 213 213 213 213 212 212 212 212 212 212 225 226 212 212 212 212 212 212 212 212 212 244 212 212 244 213 213 213
213 213 213 213 213 213 213 213 245 212 212 212 212 244 225 226 212 212 212 212 212 245 212 212 244 213 213 213 213 213 213 277
213 213 213 213 213 213 213 213 213 245 212 212 244 213 225 226 245 212 212 244 213 213 213 213 213 213 277 276 213 213 277 212
213 213 213 213 213 213 213 213 213 213 213 213 213 213 225 226 213 213 213 213 213 277 276 213 213 277 212 212 276 277 212 212
213 213 213 213 213 213 213 213 213 213 213 213 277 212 225 226 212 212 212 212 212 88 212 212 212 212 212 212 212 212 84 85
213 213 213 213 213 213 213 213 213 213 277 212 84 85 320 321 85 85 85 86 20 900 21 20 21 87 87 84 86 20 66 66
213 213 213 213 213 213 213 213 213 213 245 220 100 66 113 162 162 66 66 100 100 66 162 162 162 66 66 69 66 66 66 721
213 213 213 213 213 213 213 213 213 213 213 245 52 66 102 80 868 80 66 100 162 162 66 66 66 112 82 71 721 807 808 809
213 213 213 213 213 213 213 213 213 213 213 212 212 52 162 162 162 162 162 162 3 100 66 66 66 66 102 721 66 871 872 873
213 213 213 213 213 213 213 213 213 213 213 213 245 212 288 289 117 117 117 117 117 117 117 117 52 66 66 66 102 103 721 721
213 213 213 213 213 213 213 213 213 213 213 213 213 213 225 226 212 212 212 212 212 212 212 212 212 117 117 52 66 66 66 721
213 213 213 213 213 213 213 213 213 213 213 213 213 277 225 226 212 212 212 212 88 212 212 212 212 212 212 212 117 52 66 66
213 213 213 213 213 213 213 277 212 212 212 212 212 212 225 226 212 212 212 20 69 21 88 212 212 212 245 212 212 212 52 53
213 213 213 213 277 212 212 212 88 212 212 84 85 86 320 321 84 86 20 66 66 66 66 21 212 276 213 245 212 212 212 212
213 277 212 212 212 84 86 20 162 21 20 66 3 66 15 66 66 66 165 165 66 66 66 721 221 212 276 213 213 213 245 212
277 212 84 86 20 66 66 69 66 66 66 772 772 3 47 71 721 738 738 165 721 672 706 66 21 212 212 212 212 276 213 213
212 20 66 3 66 673 738 69 66 3 3 3 100 721 100 15 162 721 66 721 165 165 66 66 100 21 84 86 212 212 276 213
220 162 66 3 3 3 3 3 677 672 66 165 66 100 868 47 721 100 162 70 71 165 71 100 721 100 100 100 21 84 85 85
212 52 100 676 675 721 772 772 100 100 100 165 66 112 38 71 78 103 112 114 38 82 38 71 78 66 66 66 66 66 66 66
212 220 66 66 66 3 69 66 675 676 772 721 66 70 38 114 721 66 66 66 102 103 113 38 38 721 66 15 66 66 66 66
212 220 66 868 868 868 868 66 721 66 721 66 66 113 103 100 66 66 721 66 66 66 102 114 38 71 70 38 71 78 66 66
213 212 52 66 66 69 66 3 66 165 165 66 70 38 71 66 100 100 66 66 66 3 66 66 102 38 38 38 38 721 80 66
