FE5 - Fields (Green)
12 15
0 0 66 818 819 164 810 811 812 740 721 721 66 0 0
0 0 772 772 721 66 842 843 844 66 66 66 721 0 0
0 0 721 721 164 596 570 570 570 597 40 721 66 0 0
0 0 66 69 40 2 66 164 69 2 66 66 741 0 0
0 0 570 570 34 605 69 66 66 604 34 570 570 0 0
0 0 772 772 66 604 570 34 570 605 66 66 40 0 0
0 0 40 868 66 2 69 69 66 2 66 868 772 0 0
0 0 66 164 66 600 66 164 69 600 66 40 66 0 0
0 0 570 570 34 634 570 34 570 634 34 570 570 0 0
0 0 66 164 66 69 66 66 69 40 66 66 786 0 0
0 0 721 721 174 82 71 868 66 66 721 164 818 0 0
0 0 40 721 106 102 81 15 66 721 721 772 772 0 0
