FE5 - Fields (Green)
32 32
213 213 213 213 277 276 213 213 213 213 213 277 212 225 226 212 212 212 20 70 143 53 212 276 213 213 213 213 277 212 87 20
213 213 277 212 212 212 212 212 212 212 212 212 212 320 321 85 86 20 70 38 103 21 212 212 212 212 212 212 212 20 70 71
277 212 212 84 85 86 87 20 21 212 212 20 120 113 38 71 70 38 38 81 140 141 21 20 21 84 85 86 20 786 787 38
212 87 20 70 79 82 79 79 71 120 120 70 82 38 38 114 103 102 38 38 38 81 37 70 82 79 79 82 721 818 819 721
20 70 114 103 102 38 38 38 38 82 79 721 38 38 38 721 80 44 38 721 38 38 45 102 38 857 858 859 721 721 721 721
52 66 66 165 70 38 38 103 47 102 103 70 38 868 103 47 721 37 721 38 38 38 71 35 113 889 890 891 38 38 721 880
220 66 165 15 172 173 172 107 721 66 66 113 38 80 66 721 37 37 44 103 102 38 81 70 38 921 922 923 38 786 787 912
220 165 70 38 721 71 15 165 66 66 66 46 102 71 721 35 37 35 15 35 70 38 38 38 38 38 38 38 38 818 819 944
220 66 102 38 38 38 81 165 66 721 66 66 37 102 71 132 721 114 38 79 38 38 721 721 721 721 38 38 721 721 721 721
212 52 868 868 868 868 38 71 40 66 66 66 37 37 102 114 103 66 102 38 721 721 721 721 721 721 721 721 721 721 721 721
212 20 66 113 38 38 111 103 70 77 132 786 787 37 721 721 786 787 721 721 721 721 721 721 786 787 786 787 721 721 721 721
120 66 66 102 103 46 66 70 38 109 132 818 819 721 66 721 818 786 787 721 786 787 721 66 818 819 818 819 721 721 721 880
609 610 678 681 685 66 66 113 38 82 45 35 35 721 721 721 721 818 819 721 818 819 721 786 787 786 787 721 786 787 66 912
610 678 711 712 682 685 66 110 102 38 71 35 35 721 721 721 721 721 721 786 787 786 787 818 819 818 819 721 818 819 721 944
678 647 711 711 712 682 685 66 174 38 38 45 37 35 721 786 787 721 721 818 819 818 819 786 787 721 721 721 721 721 66 721
610 710 711 711 711 617 682 685 66 102 103 37 66 786 787 818 819 721 721 721 721 721 721 818 819 786 787 721 721 721 786 787
610 710 711 711 711 718 682 749 66 66 37 37 721 818 819 721 786 787 786 787 786 787 721 721 721 818 819 721 721 721 818 819
610 742 647 711 718 682 749 66 66 66 37 37 37 721 786 787 818 819 818 819 818 819 721 721 786 787 786 787 786 787 786 787
66 608 710 711 617 749 66 66 40 40 786 787 15 132 818 819 35 804 721 786 787 721 772 772 818 819 818 819 818 819 818 819
66 608 742 613 719 66 66 40 40 70 818 819 102 71 15 35 804 721 721 818 819 66 66 721 721 721 786 787 721 721 721 721
66 66 66 66 66 66 40 70 82 38 38 71 15 113 38 71 15 721 721 37 66 66 66 721 721 721 818 819 786 787 721 721
66 66 678 716 617 685 66 102 114 38 38 38 38 38 38 38 38 71 66 37 37 66 66 35 786 787 133 133 818 819 133 133
608 678 711 711 648 682 685 66 66 102 38 103 102 38 38 38 38 81 66 804 133 133 133 721 818 819 721 66 786 787 721 721
678 711 711 711 718 715 716 681 685 174 38 45 70 38 38 38 38 38 45 133 721 721 721 721 721 721 786 787 818 819 721 721
619 711 711 718 715 716 711 718 749 106 102 71 113 38 38 38 38 38 82 721 721 721 721 721 786 787 818 819 133 37 772 772
682 619 711 716 716 711 718 749 40 40 174 38 38 38 38 38 38 103 46 721 786 787 721 721 818 819 721 721 133 772 772 66
682 715 711 711 711 718 682 685 66 40 70 38 38 38 38 38 38 71 133 15 818 819 787 133 900 804 133 37 66 786 787 66
682 619 711 711 711 617 682 682 685 66 102 38 38 38 38 38 38 38 82 38 71 818 819 66 66 786 787 133 133 818 819 133
682 715 711 711 711 712 715 716 716 681 685 102 103 102 38 38 38 38 38 38 38 45 66 66 37 818 819 66 66 37 66 66
682 619 711 711 711 711 716 711 711 718 749 106 107 174 38 38 38 38 38 114 38 82 71 786 787 66 66 66 66 772 772 772
682 682 619 711 711 711 711 711 718 685 66 66 40 70 38 103 113 38 38 82 38 38 103 818 819 66 772 772 786 787 66 66
682 682 682 619 711 711 711 718 682 682 685 66 70 38 103 70 38 38 38 38 38 103 66 66 66 721 786 787 818 819 721 66
