FE5 - Fields (Green)
32 32
213 213 277 315 315 283 87 212 212 276 213 213 213 213 213 277 212 214 316 316 231 3 3 721 742 647 711 711 711 712 682 682
213 277 20 178 316 316 147 221 212 212 276 276 213 213 213 212 214 316 316 271 66 721 66 721 721 742 647 711 711 711 712 682
213 212 218 146 316 316 316 215 315 315 315 212 276 213 277 212 246 316 316 271 66 66 807 808 809 721 742 647 711 711 711 712
277 212 118 144 316 316 316 316 316 316 316 215 212 212 212 214 215 222 246 316 199 66 871 872 873 721 721 742 647 711 711 711
212 212 312 316 316 316 316 254 316 316 316 316 215 315 214 316 316 316 215 246 316 199 66 66 66 804 721 721 742 775 775 647
212 212 212 246 254 247 281 212 281 222 222 319 316 316 316 316 316 316 316 215 246 316 273 273 199 66 3 721 721 609 610 742
212 212 212 315 315 315 212 212 214 316 316 316 316 316 316 316 316 316 316 316 314 246 316 316 231 66 66 66 130 721 721 998
21 87 214 316 316 316 215 283 319 316 316 316 316 316 316 316 316 316 316 316 215 212 281 222 570 570 570 34 597 3 721 721
787 721 230 305 305 305 316 316 316 316 316 316 316 316 316 316 316 316 316 316 316 215 214 271 130 786 787 3 628 597 66 721
819 786 787 721 130 130 230 316 316 316 316 316 316 316 316 316 316 316 231 230 316 316 316 176 3 818 819 721 130 628 597 66
787 818 819 786 721 721 66 144 316 316 316 316 316 316 316 316 231 238 130 130 300 301 230 868 199 3 66 130 130 130 2 66
819 786 787 818 819 786 787 270 316 316 316 316 316 316 316 231 130 130 130 130 130 130 130 230 316 199 206 66 130 66 600 130
721 818 819 786 787 818 819 230 316 316 316 316 316 316 231 130 130 678 716 617 653 130 130 66 230 177 316 199 206 66 628 602
52 721 721 818 819 721 130 130 230 316 316 316 316 231 3 66 66 710 711 648 682 653 37 66 66 3 230 316 316 209 66 628
212 52 721 721 721 130 868 130 198 316 316 316 231 130 130 66 678 711 711 648 682 715 617 653 37 37 130 300 301 66 66 66
212 212 52 3 66 130 130 198 435 869 316 231 66 130 804 998 710 711 711 648 715 716 648 682 653 3 130 37 37 66 66 66
212 212 20 3 868 130 198 435 316 316 271 130 130 721 998 998 710 711 711 648 682 619 648 682 682 653 3 772 773 37 37 37
212 20 66 3 130 130 230 177 231 230 271 130 721 3 3 678 711 711 711 712 715 716 648 682 682 749 3 66 66 857 858 859
20 70 77 174 79 80 70 79 79 71 238 71 3 3 678 711 711 711 711 711 649 619 648 715 716 617 653 66 66 889 890 891
70 38 109 174 38 38 38 38 38 38 82 721 71 3 742 711 711 711 711 711 648 715 712 682 619 712 682 653 66 921 922 923
38 38 71 70 38 38 38 38 38 38 38 721 103 3 678 711 711 711 711 711 648 715 711 648 682 619 716 712 653 66 66 66
46 46 102 38 38 38 38 38 38 786 787 103 130 678 711 711 711 711 711 711 648 715 711 648 682 682 619 711 716 716 716 716
130 37 70 38 38 38 38 38 103 818 819 130 3 710 711 711 711 711 711 711 648 715 711 712 682 682 619 711 711 711 711 711
130 130 102 38 38 38 103 102 82 71 70 71 66 710 711 711 711 711 711 711 718 715 711 711 648 682 682 619 711 711 711 711
130 37 3 102 114 103 66 66 102 38 38 103 998 710 711 711 711 711 711 718 682 715 711 711 712 682 682 682 619 711 711 711
37 37 3 66 130 66 37 37 37 102 804 678 617 619 711 711 711 711 718 682 715 716 711 711 711 648 682 682 682 619 711 711
37 37 37 130 37 37 66 66 678 716 617 619 712 682 619 711 711 648 682 682 715 711 711 711 711 712 682 682 682 619 711 711
44 71 70 71 3 609 610 66 710 711 712 682 619 712 682 619 711 712 682 682 682 619 711 711 711 711 712 682 682 682 619 711
70 807 808 809 3 678 716 617 619 711 711 712 682 619 712 682 619 711 712 682 682 682 619 711 711 711 711 712 682 682 619 711
114 871 872 873 66 608 710 712 682 619 711 711 617 682 619 712 715 711 711 712 682 682 715 711 711 711 711 711 712 682 682 619
66 102 114 103 678 617 619 711 712 682 619 711 712 715 716 711 649 619 711 711 617 715 716 711 711 711 711 711 711 712 682 682
772 773 740 66 710 712 682 619 711 712 682 619 711 712 619 711 648 682 619 711 648 619 711 711 711 711 711 711 711 711 712 682
