FE5 - Fields (Green)
32 32
66 628 597 66 721 114 721 172 173 142 103 721 721 38 38 103 37 66 66 66 772 772 772 772 66 66 66 66 66 35 70 71
66 66 628 597 66 66 37 37 66 102 721 66 66 804 103 721 66 66 868 66 35 35 66 66 66 66 66 66 35 70 38 103
721 66 66 628 34 597 66 66 66 66 66 66 66 66 66 37 66 70 38 71 35 66 66 66 66 70 79 71 721 38 38 721
786 787 721 112 71 628 602 602 602 597 66 66 66 596 597 37 112 114 103 113 80 66 66 66 868 114 38 38 807 808 809 71
818 819 66 164 47 66 604 666 666 635 570 570 570 635 635 597 66 66 35 102 82 71 70 71 101 35 102 38 871 872 873 38
66 66 66 164 66 572 604 635 629 66 66 35 164 37 66 628 597 596 597 101 102 38 38 38 71 35 66 102 38 38 38 38
721 66 66 164 596 666 629 35 66 646 716 716 716 617 653 35 628 635 666 597 35 110 102 38 143 35 66 66 102 38 38 38
66 66 596 4 666 629 35 35 646 711 711 711 711 648 682 653 66 66 628 666 597 101 101 113 38 71 35 868 35 102 38 38
572 596 666 68 629 66 721 646 711 711 711 711 711 718 682 682 653 66 164 628 666 597 101 102 114 38 71 101 70 79 38 103
666 666 629 35 66 66 678 711 711 711 711 711 718 682 682 682 682 653 66 542 666 666 597 66 37 102 114 82 38 38 38 175
666 629 66 35 609 610 610 710 711 711 711 711 716 716 712 682 682 682 653 35 628 666 666 4 597 66 112 103 721 102 38 175
628 597 66 66 609 610 610 710 711 711 711 711 711 711 711 712 682 682 682 653 35 628 666 36 666 597 66 101 37 35 102 721
66 628 597 66 37 609 610 742 647 711 711 711 711 711 711 711 712 682 682 682 653 35 628 68 666 666 597 35 35 66 66 66
66 66 2 66 37 609 610 610 710 711 711 711 711 711 711 711 711 712 682 682 682 721 35 35 628 666 666 597 66 164 772 772
787 66 564 66 37 37 609 610 742 647 711 711 711 711 711 711 711 718 682 682 749 900 35 35 542 635 564 564 52 119 119 164
819 37 221 52 37 37 37 721 608 742 647 711 711 711 711 711 718 682 682 749 721 35 786 787 35 35 21 212 212 212 212 52
37 66 221 212 52 119 66 721 721 608 710 711 711 711 711 718 682 682 749 857 858 859 818 819 35 37 53 212 212 244 245 212
596 34 212 87 212 212 52 119 609 610 742 775 647 711 711 716 718 749 38 889 890 891 35 35 37 53 212 212 244 213 213 245
629 37 120 66 21 212 212 220 66 112 609 610 742 775 647 718 164 106 102 921 922 923 35 66 53 212 212 244 213 213 213 213
66 37 66 66 53 212 212 220 35 608 38 609 610 610 742 719 164 721 82 38 103 35 66 53 212 212 244 213 213 213 213 213
66 66 37 53 212 212 212 212 52 35 608 114 103 721 609 610 66 721 721 103 164 35 53 212 212 212 276 213 213 213 213 213
772 772 37 21 212 212 212 212 212 52 35 35 35 102 103 70 82 721 35 35 164 53 212 212 212 212 212 212 276 213 213 213
112 82 71 66 21 212 212 212 212 212 52 119 119 35 35 47 102 103 66 164 53 212 212 212 212 212 212 87 212 212 276 213
70 38 38 82 71 21 212 212 212 212 212 212 212 52 66 66 66 66 66 53 212 212 212 212 212 212 20 101 21 212 212 276
102 807 808 809 38 80 221 212 212 212 212 212 212 212 4 4 4 52 53 212 212 212 212 212 87 20 164 164 164 21 84 85
164 871 872 873 103 66 600 21 84 85 86 212 212 212 212 212 212 212 212 212 212 212 212 20 164 37 101 101 101 112 82 79
786 787 164 721 804 37 600 37 70 79 71 21 20 21 68 68 68 84 85 86 212 212 20 101 35 37 37 721 37 37 47 102
818 819 35 37 164 596 629 70 38 804 804 79 79 79 38 81 102 79 79 71 21 20 37 37 35 721 66 66 721 37 721 786
597 37 596 34 570 629 70 103 102 38 721 38 103 721 113 103 35 721 102 38 71 37 721 66 66 66 35 721 721 721 66 818
666 570 629 38 71 70 114 45 37 46 66 807 808 809 38 71 37 37 37 102 721 82 721 66 66 868 66 35 786 787 35 164
629 38 38 114 38 103 721 66 721 721 66 871 872 873 38 38 80 66 101 721 102 786 787 71 66 66 164 772 818 819 786 787
103 172 173 66 47 721 786 787 66 786 787 66 66 721 721 103 772 772 101 164 721 818 819 721 772 772 772 721 786 787 818 819
