FE5 - Fields (Day)
32 32
712 682 682 685 742 647 711 716 617 749 742 775 775 719 66 609 610 609 610 609 610 610 66 66 66 66 66 66 66 66 66 66
711 617 682 682 685 742 775 613 719 66 66 609 610 66 609 610 608 609 610 609 610 66 608 66 66 66 807 808 809 66 66 66
711 718 682 682 749 66 66 15 66 66 66 66 66 66 609 610 66 609 610 609 610 836 836 996 71 66 871 872 873 15 609 610
718 682 682 749 66 66 174 38 71 66 66 678 716 716 716 617 685 614 685 609 610 900 900 38 38 71 66 78 70 38 609 610
712 682 682 685 78 78 70 38 103 66 608 742 711 711 711 718 715 775 712 685 608 66 102 38 38 38 82 38 38 609 610 614
711 617 682 749 38 38 38 114 175 66 66 608 710 711 711 617 654 572 742 712 685 608 66 102 38 38 38 609 610 610 678 711
711 718 682 685 38 38 38 71 66 66 678 716 617 715 711 718 654 604 597 742 719 998 608 66 102 38 608 609 610 610 710 711
718 682 682 717 102 38 38 38 71 66 710 711 712 619 718 682 654 604 605 614 712 685 998 66 70 38 103 721 609 678 647 711
712 682 682 682 685 102 38 38 38 71 742 647 711 712 715 617 654 628 605 742 775 719 721 70 38 38 71 66 609 610 710 711
711 648 682 682 749 70 38 38 38 103 78 742 647 711 716 718 682 685 604 597 66 66 66 47 102 114 81 66 609 610 742 647
711 648 682 682 685 102 38 38 38 82 609 610 710 711 718 750 750 749 628 634 570 570 597 66 66 66 113 71 66 609 610 710
711 712 682 682 682 685 38 38 38 38 38 608 742 775 719 609 610 71 608 38 38 38 628 34 602 597 102 38 175 609 610 710
711 711 617 682 682 654 38 38 38 38 38 38 38 38 609 610 609 610 71 113 38 81 46 66 628 634 597 38 175 609 610 710
711 711 718 682 682 654 102 721 38 38 38 38 38 38 38 103 102 38 38 38 38 38 71 66 66 66 600 102 609 610 614 711
711 718 682 682 682 749 66 102 721 38 38 38 38 114 614 716 617 685 38 38 38 38 38 71 66 66 600 66 47 742 647 711
711 617 682 682 749 66 66 174 38 38 38 103 609 610 711 711 648 682 685 38 114 38 38 103 721 66 600 66 66 66 742 647
711 712 682 682 685 66 66 70 38 38 38 609 610 614 711 711 648 682 682 685 66 102 38 175 721 721 604 597 66 66 66 742
711 711 617 682 749 78 70 38 38 38 609 610 678 711 711 711 648 682 682 682 685 70 38 175 66 596 666 666 34 570 597 608
711 711 718 654 102 38 38 38 38 103 609 610 710 711 711 711 712 682 682 682 682 685 102 71 66 604 666 629 66 66 628 570
711 718 682 654 70 38 38 38 81 608 608 678 711 711 711 711 711 712 682 682 682 749 70 81 66 628 605 66 66 66 66 66
718 682 682 654 110 102 38 38 38 38 608 742 647 711 711 711 711 711 617 682 682 685 102 38 71 66 2 71 66 66 66 66
716 712 682 654 66 174 38 38 38 103 66 608 710 711 711 711 711 711 712 682 682 682 685 38 81 66 2 38 845 846 847 71
711 711 617 654 608 82 38 114 103 66 609 610 710 711 711 711 711 711 711 712 682 682 717 38 81 66 600 38 877 878 879 38
711 711 718 682 685 102 38 71 66 66 678 716 711 711 711 711 711 711 711 711 617 682 682 685 38 71 600 102 909 910 911 38
711 718 682 682 654 70 38 38 71 609 610 710 711 711 711 711 711 711 711 711 718 682 682 717 102 103 600 66 113 38 38 38
711 617 682 682 654 608 38 38 103 609 610 710 649 619 711 711 711 711 711 718 682 682 682 749 66 66 604 597 102 38 38 38
711 718 682 750 749 82 38 103 66 66 678 711 648 682 619 711 711 711 718 682 682 682 682 685 66 66 628 605 66 110 110 110
718 682 654 609 610 110 110 66 609 610 710 711 718 682 682 619 711 718 682 682 715 716 712 682 685 66 596 666 218 66 66 66
682 682 749 608 804 71 78 609 610 678 711 718 715 716 712 715 711 712 682 779 716 711 711 712 682 685 604 605 66 66 66 66
682 749 608 804 38 38 81 609 610 710 648 779 716 711 711 712 619 711 712 682 619 711 711 711 617 654 628 666 597 66 66 66
749 66 66 70 38 38 609 610 614 711 712 682 619 711 711 711 712 711 711 716 712 619 711 711 648 654 596 666 666 597 66 66
685 66 66 142 38 609 610 614 711 711 711 712 715 711 711 711 711 711 711 711 711 716 712 619 718 654 604 666 666 629 66 66
