FE5 - Fields (Snow)
13 18
66 66 66 102 38 786 787 66 66 66 66 66 600 14 70 38 38 38
66 721 66 44 38 818 819 66 66 66 66 66 628 597 38 38 33 38
66 66 66 70 38 38 45 66 66 721 14 14 66 600 114 103 66 102
66 66 70 38 38 81 66 66 66 70 38 103 66 2 66 66 66 66
66 66 113 38 114 103 66 721 66 102 38 71 66 628 570 597 66 66
14 70 786 787 66 66 866 738 867 44 38 81 14 66 66 628 597 66
38 38 818 819 66 66 960 66 961 721 102 38 103 66 66 66 600 66
38 38 38 81 66 721 741 772 740 66 66 46 66 66 66 66 628 597
38 38 103 46 66 66 66 66 66 66 66 66 721 66 66 66 66 600
38 103 66 66 66 786 787 66 66 66 66 78 78 70 71 721 66 600
46 66 66 66 66 818 819 66 78 70 82 38 38 38 38 71 66 628
66 66 66 66 66 66 78 14 113 38 721 38 38 38 786 787 71 66
66 66 66 66 66 70 38 38 38 38 38 38 38 38 818 819 38 71
