FE5 - Fields (Snow)
32 32
718 682 682 682 749 66 596 629 70 103 66 66 66 102 38 114 38 71 66 40 40 40 40 40 40 40 721 721 742 647 711 711
712 682 682 749 40 596 629 70 103 66 66 66 66 174 103 40 102 114 71 132 132 132 132 596 602 597 572 35 721 742 647 711
711 617 717 66 596 629 70 103 66 66 66 40 40 721 132 132 132 721 46 66 66 66 66 628 666 666 666 597 70 721 742 647
711 718 717 596 629 70 103 66 66 596 539 539 539 539 539 539 539 539 539 539 602 597 35 35 628 666 666 605 38 71 66 742
718 682 749 604 597 113 71 66 596 629 40 66 66 66 66 66 66 66 66 66 628 666 597 66 66 628 666 605 38 103 721 66
682 749 66 636 629 113 103 596 629 40 66 66 66 165 165 165 66 66 35 35 35 628 666 597 35 219 666 605 103 35 35 721
749 66 66 600 70 103 132 600 40 66 66 66 66 596 539 34 539 539 602 597 165 66 628 605 66 66 628 605 35 35 35 66
66 66 66 2 38 175 132 600 66 66 66 66 596 721 66 66 66 721 628 605 66 165 35 600 66 868 35 600 66 66 35 35
66 14 66 600 103 66 132 600 78 78 15 596 721 66 938 939 940 66 721 600 174 82 175 628 597 66 66 600 66 66 66 132
70 38 721 600 66 66 132 2 113 868 38 600 66 66 970 971 972 35 66 600 174 33 71 35 636 597 66 600 82 71 132 66
38 81 66 600 66 132 132 600 721 103 102 600 66 66 1002 1003 1004 66 721 600 35 102 81 35 636 635 539 605 38 38 71 66
102 38 721 600 66 132 40 600 66 66 721 600 40 35 66 66 66 66 721 600 35 66 102 596 629 165 165 600 38 103 46 66
66 142 81 600 66 132 66 600 66 66 66 636 597 721 66 66 66 66 66 2 66 165 165 600 66 66 165 600 38 175 66 66
66 142 103 600 66 132 66 600 66 35 35 628 666 597 721 721 66 721 596 605 165 66 66 600 197 66 66 2 38 175 66 66
66 102 45 600 40 132 66 636 597 66 66 66 628 634 539 539 539 539 666 605 66 66 596 666 541 66 66 600 113 71 66 66
66 174 71 600 40 132 66 628 666 597 66 66 66 66 66 66 868 165 604 666 597 596 666 629 66 35 66 600 102 38 175 66
66 174 103 600 40 66 35 66 628 666 597 66 132 132 132 132 165 596 666 666 666 666 629 66 132 35 596 629 66 110 132 132
66 70 71 600 40 35 132 132 132 628 666 597 132 66 66 596 602 635 635 666 666 629 66 132 66 596 629 132 35 70 71 66
66 102 81 600 35 35 66 66 66 66 628 634 539 539 539 634 629 66 66 573 573 132 132 66 132 600 35 35 174 38 38 79
66 174 103 628 539 597 66 66 66 66 66 165 165 66 66 721 66 66 66 66 66 132 66 132 132 600 35 35 174 38 33 103
66 66 66 35 15 628 597 66 66 165 165 66 66 66 66 66 66 66 66 66 132 132 596 539 539 629 66 35 35 110 110 66
66 66 66 35 102 71 628 597 165 66 66 66 66 66 66 66 66 132 33 132 721 596 629 35 132 66 66 66 66 35 35 66
66 66 66 35 35 102 71 628 539 597 132 66 66 721 132 132 132 66 66 35 596 629 66 66 66 132 66 165 165 78 70 71
786 787 66 35 35 35 102 102 103 628 539 539 539 539 539 539 539 539 539 539 629 66 66 165 165 165 165 165 70 38 786 787
818 819 71 35 66 66 66 35 35 35 35 35 14 132 721 79 103 174 71 35 35 35 35 35 35 35 132 66 113 38 818 819
66 102 38 71 66 66 66 66 66 66 174 82 103 35 110 102 175 66 46 165 66 66 66 66 66 66 35 70 38 38 880 880
66 70 38 103 66 66 66 66 66 35 35 46 35 66 66 165 165 35 35 35 35 35 35 78 35 35 35 102 38 786 787 912
174 38 38 82 175 66 15 132 35 35 66 66 66 866 738 867 66 66 66 66 66 174 786 787 175 66 132 174 38 818 819 944
174 38 38 38 175 70 38 71 66 66 66 66 165 960 66 961 66 66 66 66 66 174 818 819 71 132 66 66 102 38 880 880
66 113 38 103 70 786 787 38 71 66 66 165 66 741 772 740 66 66 66 66 66 66 102 38 103 132 66 66 165 102 38 912
174 38 786 787 38 818 819 880 881 882 165 66 66 66 66 66 66 66 66 66 66 66 66 110 132 66 66 66 165 174 38 944
70 38 818 819 38 38 38 912 913 914 66 66 66 66 66 66 66 66 66 66 66 66 66 66 132 66 66 66 165 66 102 71
