FE5 - Fields (Day)
11 16
0 721 66 772 66 66 721 721 721 772 721 721 38 38 103 0
0 721 66 66 66 737 772 740 66 66 66 721 721 110 721 0
0 66 66 66 66 66 998 998 998 66 66 78 78 740 674 0
0 71 66 66 66 998 15 70 82 998 70 38 868 66 66 0
0 38 71 66 998 66 102 38 38 82 998 38 80 66 66 0
0 38 103 15 66 66 112 38 38 114 38 38 71 66 721 0
0 103 70 103 998 66 66 103 102 80 998 38 38 103 721 0
0 721 70 80 66 998 66 66 66 998 110 110 868 66 66 0
0 721 47 66 66 66 998 998 998 772 675 66 66 741 772 0
0 66 721 78 66 66 66 66 66 66 66 66 721 721 66 0
0 721 102 38 71 721 721 721 66 66 66 721 721 66 772 0
