FE5 - Castle v2 (Purple)
32 32
548 548 548 548 548 548 548 362 548 548 548 548 548 548 548 548 548 548 548 548 548 548 548 548 548 362 548 548 548 548 548 548
548 548 548 548 548 548 548 339 548 548 548 548 548 548 548 548 548 548 548 548 548 548 548 548 548 339 548 548 548 548 548 548
548 548 548 548 548 548 548 362 580 580 580 580 580 580 580 580 823 580 580 580 580 580 580 580 580 362 548 548 548 548 548 548
580 580 580 580 580 580 580 362 1005 1006 1006 1006 1006 1006 1006 1006 855 1006 1006 1006 1006 1006 1006 1006 1006 362 580 580 580 580 580 580
689 689 689 689 689 689 689 362 1005 1006 1006 1006 1006 1006 1006 1006 1006 1006 1006 1006 1006 1006 1006 1006 1006 362 689 689 689 689 689 689
689 689 689 689 689 689 689 362 1005 1006 1006 1006 1006 1006 950 950 951 952 952 1006 1006 1006 1006 1006 1006 362 689 689 689 689 689 689
689 689 689 689 689 689 689 362 1005 1006 1006 1006 1006 1006 950 885 983 886 952 1006 1006 1006 1006 1006 1006 362 689 689 689 689 689 689
689 689 689 689 689 689 689 362 1005 1006 1006 1006 1006 1006 982 983 983 983 984 1006 1006 1006 1006 1006 1006 362 689 689 689 689 689 689
689 689 689 689 689 689 689 362 1005 1006 1006 1006 1006 1006 1014 917 983 918 1016 1006 1006 1006 1006 1006 1006 362 689 689 689 689 689 689
689 689 689 689 689 689 689 362 1005 1006 1006 1006 1006 1006 1014 1014 1015 1016 1016 1006 1006 1006 1006 1006 1006 362 689 689 689 689 689 689
689 689 689 689 689 689 689 387 398 398 398 398 339 1005 1006 1006 1006 1006 1006 1006 339 398 398 398 398 393 689 689 689 689 689 689
689 689 689 689 689 689 689 515 548 548 548 548 362 1005 1006 1006 1006 1006 1006 1006 362 548 548 548 548 517 689 689 689 689 689 689
689 689 689 689 689 689 689 547 548 548 548 548 362 425 458 458 458 458 458 459 362 548 548 548 548 549 689 689 689 689 689 689
689 689 689 689 689 689 689 547 548 548 548 548 362 425 458 458 458 458 458 459 362 548 548 548 548 549 689 689 689 689 689 689
689 689 689 689 689 689 689 547 548 548 548 548 362 425 458 458 458 458 458 459 362 548 548 548 548 549 689 689 689 689 689 689
689 689 689 689 689 689 689 579 580 580 580 580 362 425 458 458 458 458 458 459 362 580 580 580 580 581 689 689 689 689 689 689
689 689 689 689 689 689 689 689 689 689 689 689 339 425 458 458 458 458 458 459 339 689 689 689 689 689 689 689 689 689 689 689
689 689 689 689 689 689 689 689 689 689 689 689 371 339 1005 1006 1006 1006 1006 339 371 689 689 689 689 689 689 689 689 689 689 689
689 689 689 689 689 689 689 689 689 689 689 689 403 362 1005 1006 1006 1006 1006 362 403 689 689 689 689 689 689 689 689 689 689 689
689 689 689 689 689 689 689 689 689 689 689 689 435 362 1005 1006 1006 1006 1006 362 435 689 689 689 689 689 689 689 689 689 689 689
689 689 689 689 689 689 689 689 689 689 689 689 689 362 1005 1006 1006 1006 1006 362 689 689 689 689 689 689 689 689 689 689 689 689
689 689 689 689 689 689 689 689 689 689 689 689 689 362 1005 1006 1006 1006 1006 362 689 689 689 689 689 689 689 689 689 689 689 689
689 689 689 689 689 689 689 689 689 689 689 689 689 362 1005 1006 1006 1006 1006 362 689 689 689 689 689 689 689 689 689 689 689 689
689 689 689 689 689 689 689 689 689 689 689 689 689 362 1005 1006 1006 1006 1006 362 689 689 689 689 689 689 689 689 689 689 689 689
689 689 689 689 689 689 689 689 689 689 689 689 689 362 1005 1006 1006 1006 1006 362 689 689 689 689 689 689 689 689 689 689 689 689
689 689 689 689 689 689 689 689 689 689 689 689 689 362 1005 1006 1006 1006 1006 362 689 689 689 689 689 689 689 689 689 689 689 689
689 689 689 689 689 689 689 689 689 689 689 689 689 362 1005 1006 1006 1006 1006 362 689 689 689 689 689 689 689 689 689 689 689 689
689 689 689 689 689 689 689 689 689 689 689 689 689 362 1005 1006 1006 1006 1006 362 689 689 689 689 689 689 689 689 689 689 689 689
689 689 689 689 689 689 689 689 689 689 689 689 689 362 1005 1006 1006 1006 1006 362 689 689 689 689 689 689 689 689 689 689 689 689
689 689 689 689 689 689 689 689 689 689 689 689 689 362 1005 1006 1006 1006 1006 362 689 689 689 689 689 689 689 689 689 689 689 689
689 689 689 689 689 689 689 689 689 689 689 689 689 362 1005 1006 1006 1006 1006 362 689 689 689 689 689 689 689 689 689 689 689 689
689 689 689 689 689 689 689 689 689 689 689 689 689 362 1005 1006 1006 1006 1006 362 689 689 689 689 689 689 689 689 689 689 689 689
