FE5 - Fields (Green)
26 32
711 718 617 648 749 66 66 609 610 608 609 610 175 596 629 66 66 66 66 737 772 740 721 786 787 818 819 721 786 787 786 787
718 717 742 719 998 66 162 721 66 66 44 103 107 2 66 66 721 70 82 71 66 66 66 818 819 66 66 721 818 819 818 819
617 717 807 808 809 804 162 678 716 681 751 66 66 600 678 653 110 102 38 38 82 71 66 721 721 786 787 66 66 721 721 786
712 717 871 872 873 66 66 710 711 648 653 66 66 564 742 712 653 66 102 38 38 38 80 66 66 818 819 66 66 721 721 818
711 617 653 162 66 678 716 711 711 718 682 653 53 212 52 742 712 653 174 114 38 38 82 71 66 66 66 786 787 721 786 787
711 718 749 66 678 647 711 711 718 682 717 53 212 212 220 742 647 712 653 66 102 38 38 38 82 71 66 818 819 721 818 819
718 749 37 66 998 742 711 718 682 682 749 221 212 212 220 998 742 711 617 653 66 113 38 38 38 103 66 772 740 721 721 721
749 721 66 678 716 716 711 716 617 682 653 221 212 212 220 742 647 711 648 717 37 102 38 38 81 78 75 66 66 66 721 786
721 162 162 710 711 711 711 711 648 682 717 21 212 212 212 52 710 711 648 717 66 70 37 721 102 102 175 66 66 100 66 818
45 66 66 710 711 711 711 711 718 682 682 653 221 244 212 220 710 711 718 717 162 110 110 162 66 70 71 66 66 66 100 66
685 66 66 710 711 711 711 718 682 682 717 53 244 213 245 220 710 718 682 682 653 66 37 66 162 102 81 162 786 787 786 787
717 721 66 710 711 711 718 682 682 682 717 21 276 213 213 220 710 712 682 682 682 653 37 66 66 37 102 721 818 819 818 819
749 80 162 710 711 711 716 617 682 682 717 53 212 213 213 220 710 711 716 617 682 717 66 140 141 37 66 721 721 786 787 786
608 15 162 742 711 711 711 648 682 682 749 221 212 213 213 220 742 711 711 648 682 717 82 38 38 71 66 66 162 818 819 818
174 81 15 609 742 711 711 648 682 749 53 212 244 213 213 245 52 742 711 718 749 100 721 804 114 103 66 70 80 162 786 787
106 102 114 609 610 742 647 718 749 53 212 212 213 213 213 213 212 52 742 719 53 52 100 66 66 66 162 113 175 66 818 819
721 66 70 81 609 610 742 719 53 212 212 212 276 213 213 213 245 212 117 117 212 220 162 53 52 100 66 102 82 71 66 721
787 721 102 114 71 66 100 219 212 87 20 21 212 276 213 213 213 245 212 212 212 87 34 212 212 52 74 70 38 81 772 772
819 721 721 66 102 80 100 66 573 857 858 859 21 212 212 276 277 212 212 212 20 37 66 21 220 120 174 38 38 38 71 66
721 786 787 66 66 162 70 80 162 889 890 891 162 120 120 21 212 212 212 212 37 868 66 162 221 52 66 110 102 38 38 71
721 818 819 66 53 52 900 71 78 921 922 923 71 78 78 7 8 8 8 9 66 66 868 219 212 212 52 66 66 102 38 81
787 721 66 53 212 220 110 110 110 102 114 38 38 38 103 219 212 212 212 212 52 868 162 66 221 212 212 52 162 162 113 38
819 66 53 212 212 220 836 162 162 100 66 102 114 103 100 53 212 212 212 212 220 66 66 53 212 212 212 20 162 66 102 102
786 787 21 212 244 245 52 53 117 52 66 66 100 100 53 212 244 213 213 245 212 212 117 212 212 212 20 162 66 70 71 66
818 819 53 212 213 213 245 212 212 212 52 53 117 117 212 244 213 213 213 213 213 245 212 212 212 20 66 66 70 38 38 71
787 66 21 212 276 213 213 213 213 245 212 212 212 212 244 213 213 213 213 213 213 213 245 212 20 66 66 70 38 38 38 38
