FE5 - Fields (Green)
32 32
787 66 66 66 66 912 913 913 913 914 721 721 3 721 66 66 721 3 3 721 66 66 66 66 66 66 66 66 818 819 880 881
819 3 66 66 721 944 913 913 913 914 721 3 786 787 78 78 141 66 3 66 66 721 66 66 66 66 66 66 66 721 912 913
66 164 3 880 881 882 944 945 945 946 3 3 818 819 113 38 38 71 75 66 66 66 66 69 66 66 66 66 66 66 944 945
721 786 787 944 945 946 721 721 721 3 140 141 66 66 102 857 858 859 107 66 74 75 66 721 66 165 165 165 165 165 786 787
721 818 819 721 880 881 882 721 3 3 102 868 71 69 721 889 890 891 66 70 868 137 165 165 165 165 66 66 66 66 818 819
786 787 66 721 944 945 946 66 66 3 3 102 103 66 721 921 922 923 721 38 114 38 721 69 66 786 787 721 66 69 69 66
818 819 66 66 721 721 66 70 82 175 69 3 3 3 164 66 69 69 110 110 66 102 81 69 69 818 819 69 69 66 66 66
721 66 66 786 787 66 66 113 38 71 70 71 66 721 3 66 66 165 165 721 66 70 38 868 69 69 69 786 787 721 66 66
3 3 66 818 819 721 44 38 114 103 102 114 71 164 66 3 3 165 69 66 721 102 114 103 69 69 69 818 819 721 66 66
66 66 66 66 786 787 70 38 45 69 69 69 721 69 164 164 164 165 66 721 66 786 787 69 66 66 66 69 66 66 66 66
721 66 66 66 818 819 102 173 721 69 721 721 66 721 66 69 165 164 3 66 721 818 819 721 66 786 787 66 69 69 66 165
786 787 66 66 721 721 721 66 721 164 786 787 721 66 721 3 165 3 164 721 880 881 882 786 787 818 819 66 786 787 165 69
818 819 164 66 786 787 721 786 787 721 818 819 786 787 3 66 165 66 164 721 912 913 914 818 819 721 721 66 818 819 66 66
721 786 787 3 818 819 721 818 819 721 66 69 818 819 786 787 66 721 721 69 944 945 946 880 881 882 165 165 66 66 66 66
721 818 819 721 66 721 786 787 721 66 3 868 69 66 818 819 786 787 721 66 868 3 721 912 913 914 66 66 66 66 66 53
119 721 786 787 66 66 818 819 66 66 3 66 69 69 165 721 818 819 721 164 66 66 165 944 945 946 66 786 787 66 53 212
212 52 818 819 721 66 66 721 721 3 721 721 66 164 165 164 69 164 164 66 66 165 165 66 721 721 66 818 819 53 212 212
212 212 52 721 880 881 882 66 3 721 880 881 882 164 165 69 164 69 69 69 721 721 66 66 66 3 66 786 787 21 212 244
245 212 212 52 944 945 946 3 66 721 912 913 914 721 721 66 66 66 66 880 881 882 721 66 66 3 721 818 819 53 212 213
213 245 212 212 52 66 66 721 164 164 944 945 946 721 721 721 66 66 721 912 913 914 721 66 66 786 787 721 53 212 244 213
213 213 245 212 212 52 721 66 165 119 140 78 721 721 880 881 882 880 882 944 945 946 3 3 66 818 819 53 212 244 213 213
213 213 213 245 212 212 117 117 117 20 165 102 71 165 912 913 914 912 914 882 721 721 165 66 880 881 882 21 212 276 213 213
213 213 213 213 245 212 212 212 20 66 70 82 103 721 944 945 946 944 945 946 721 66 66 165 912 913 914 721 21 212 276 213
213 213 213 213 277 212 20 120 66 70 721 38 175 721 721 880 881 882 721 66 66 66 66 721 944 945 946 721 721 21 212 213
213 213 213 277 212 20 66 66 70 38 804 38 804 3 721 912 913 914 721 3 3 3 3 721 786 787 880 881 882 721 21 276
213 213 277 212 20 721 721 66 113 38 38 721 71 66 66 944 945 946 721 165 165 721 66 165 818 819 912 913 914 721 219 212
276 277 212 20 880 881 882 66 102 804 38 804 804 66 66 66 786 787 69 66 66 807 808 809 66 721 944 945 946 721 721 221
20 21 20 721 912 913 914 721 721 172 173 102 175 3 66 721 818 819 66 69 721 871 872 873 66 66 721 880 881 882 721 721
721 880 881 882 944 945 946 880 881 882 66 66 66 66 66 786 787 721 66 66 66 66 66 66 66 66 721 912 913 914 786 787
787 912 913 914 880 881 882 912 913 914 721 66 66 786 787 818 819 721 721 66 66 66 721 66 66 786 787 944 945 946 818 819
819 944 945 946 912 913 914 944 945 946 721 721 66 818 819 880 881 882 721 721 66 66 66 66 66 818 819 786 787 880 881 882
880 881 882 721 944 945 946 786 787 880 881 882 880 881 882 912 913 914 786 787 721 66 66 66 66 721 721 818 819 912 913 914
