FE5 - Fields (Green)
32 32
66 66 66 66 66 66 66 66 66 66 448 786 787 786 787 721 818 819 721 66 66 448 66 66 66 66 66 66 66 66 66 66
66 66 721 721 786 787 721 66 66 66 497 461 461 461 461 461 461 461 461 461 461 497 786 787 66 66 66 66 721 721 66 66
66 786 787 721 818 819 786 787 66 721 657 495 493 493 493 582 549 582 493 493 493 657 818 819 66 66 66 66 66 66 66 66
66 625 458 458 458 458 458 458 626 786 657 423 422 422 582 423 581 423 582 423 422 657 721 625 458 458 458 458 458 458 626 161
66 657 423 422 422 422 422 422 657 818 657 487 455 455 582 487 455 455 582 487 455 657 734 657 423 422 422 422 422 422 657 161
721 657 487 455 455 455 455 455 657 734 657 487 455 455 582 487 455 455 582 487 455 657 725 657 487 455 455 455 455 455 657 161
786 657 487 455 455 455 455 455 522 458 523 487 455 455 582 487 455 455 582 487 455 522 458 523 487 455 455 455 455 455 657 161
818 657 487 455 455 455 455 455 422 422 422 455 455 455 455 455 455 455 455 455 455 422 422 422 455 455 455 455 455 455 657 161
66 657 487 455 455 455 455 455 625 461 626 487 455 455 455 455 455 455 455 455 455 625 461 626 487 455 455 455 455 455 657 161
66 490 461 626 487 625 461 461 491 527 657 487 455 455 455 455 455 455 455 455 455 657 527 490 461 626 487 625 461 461 491 161
721 494 525 657 487 657 527 525 525 591 352 461 461 461 461 461 461 461 461 461 461 353 725 526 525 657 487 657 527 525 528 161
721 625 458 523 484 522 458 458 626 725 354 525 525 525 525 525 525 525 525 525 525 355 725 625 458 523 484 655 458 458 626 161
787 657 423 422 422 422 422 422 657 725 386 589 589 589 589 589 589 589 589 589 589 387 725 657 423 422 422 657 423 422 657 161
819 657 487 455 455 455 455 455 657 725 448 725 766 66 66 66 66 66 66 66 730 448 730 657 487 455 455 657 487 455 657 161
70 657 487 455 582 487 455 455 657 725 497 458 458 458 458 458 458 458 458 458 458 497 729 657 487 455 455 657 487 455 657 721
721 657 487 455 455 455 455 455 522 458 523 423 422 422 422 422 422 422 422 422 422 522 458 523 487 455 455 657 487 455 657 721
721 657 487 455 582 487 455 455 455 455 455 455 455 455 455 455 455 455 455 455 455 422 422 422 455 455 455 657 487 455 657 787
786 657 487 455 455 455 455 455 620 621 622 487 455 455 455 455 455 455 455 455 455 620 621 621 621 621 621 621 621 621 624 819
818 657 487 455 582 487 455 455 623 588 624 487 455 455 455 455 455 455 455 455 455 623 588 624 555 555 555 555 555 555 656 161
721 657 487 455 455 455 455 455 522 555 523 487 455 455 455 455 455 455 455 455 455 522 555 523 423 422 422 422 422 422 657 161
66 657 487 455 582 487 455 455 422 422 422 455 455 455 455 455 455 455 455 455 455 422 422 422 455 455 455 455 455 455 657 161
787 657 487 455 455 455 455 455 620 621 622 487 455 455 455 455 455 455 455 455 455 620 621 622 487 455 455 455 33 33 657 786
819 657 487 455 582 487 455 455 522 555 523 487 455 455 455 455 455 455 455 455 455 522 555 555 458 458 458 458 458 458 656 818
721 657 487 455 455 455 455 455 422 422 422 455 455 455 455 455 455 455 455 455 455 422 422 422 422 422 422 422 422 422 657 721
721 657 487 455 582 487 455 455 625 461 626 487 455 455 448 487 455 448 487 455 455 625 461 626 487 455 455 455 455 455 657 721
721 657 487 455 455 455 455 455 657 527 657 487 455 455 529 487 455 529 487 455 455 657 527 655 458 458 459 484 457 458 656 721
66 657 487 455 582 487 455 455 657 591 352 461 461 461 561 421 421 561 461 461 461 353 591 657 423 422 422 422 422 422 657 161
66 657 487 455 455 455 455 455 657 725 354 525 525 525 561 421 421 561 527 525 525 355 725 657 487 455 455 33 487 455 657 786
721 657 487 455 455 455 455 455 657 725 386 589 589 589 593 421 421 561 591 589 589 387 725 657 487 455 455 455 455 455 657 818
721 352 461 461 461 461 461 461 353 725 724 734 730 724 724 421 421 725 734 66 730 766 730 352 461 461 461 461 461 461 353 161
66 354 525 525 525 525 525 525 355 766 730 766 66 730 724 724 766 730 766 66 729 734 66 354 525 525 525 525 525 525 355 161
66 386 589 589 589 589 589 589 387 734 66 66 66 729 724 766 729 734 66 66 730 766 66 386 589 589 589 589 589 589 387 161
