FE5 - Fields (Green)
32 32
66 66 546 66 66 66 66 66 66 66 448 786 787 786 787 721 818 819 721 66 66 448 66 66 66 66 66 66 66 66 66 66
66 66 721 721 786 787 721 66 66 66 497 481 482 482 482 482 482 482 482 482 482 497 786 787 66 66 66 66 721 721 66 66
66 448 66 66 66 66 66 66 448 721 512 513 514 514 514 514 514 514 514 514 514 515 818 448 66 66 66 66 66 66 448 66
66 497 481 482 482 482 482 482 497 786 512 513 514 514 514 514 514 514 514 514 514 515 721 497 481 482 482 482 482 482 497 161
66 512 513 514 514 514 514 514 515 818 512 513 514 514 514 514 514 514 514 514 514 515 734 512 513 514 514 514 514 514 515 161
721 512 513 514 514 514 514 514 515 734 512 513 514 514 514 514 514 514 514 514 514 515 725 512 513 514 514 514 514 514 515 161
786 512 513 514 514 514 514 514 482 482 482 514 514 514 514 514 514 514 514 514 514 482 482 482 514 514 514 514 514 546 515 161
818 448 545 546 580 546 546 546 448 546 546 546 514 514 514 514 514 514 514 514 546 546 546 448 545 546 514 546 546 452 448 161
66 497 577 512 513 452 577 577 497 461 448 512 546 546 546 546 546 546 546 546 515 448 461 497 577 512 513 452 577 578 497 161
66 490 461 512 545 515 461 461 491 527 497 576 577 577 577 577 577 577 577 577 578 497 527 490 461 512 545 515 461 461 491 161
721 526 525 576 577 578 527 525 528 591 352 461 461 461 461 461 461 461 461 461 461 353 725 526 525 576 577 578 527 525 528 161
721 625 458 523 484 522 458 458 626 725 354 525 525 525 525 525 525 525 525 525 525 355 725 625 458 523 484 655 458 458 626 161
787 657 423 422 422 422 422 422 657 725 386 589 589 589 589 589 589 589 589 589 589 387 725 657 423 422 422 657 423 422 657 161
819 657 487 455 455 455 455 455 657 725 448 725 766 66 66 66 66 66 66 66 730 448 730 657 487 455 455 657 487 455 657 161
70 657 487 455 582 487 455 455 657 725 497 458 458 458 458 458 458 458 458 458 458 497 729 657 487 455 455 657 487 455 657 721
721 657 487 455 455 455 455 455 522 458 523 423 422 422 422 422 422 422 422 422 422 522 458 523 487 455 455 657 487 455 657 721
721 657 487 455 582 487 455 455 455 455 455 455 455 455 455 455 455 455 455 455 455 422 422 422 455 455 455 657 487 455 657 787
786 657 487 455 455 455 455 455 620 621 622 487 455 455 455 455 455 455 455 455 455 620 621 621 621 621 621 621 621 621 624 819
818 657 487 455 582 487 455 455 623 588 624 487 455 455 455 455 455 455 455 455 455 623 588 624 555 555 555 555 555 555 656 161
721 657 487 455 455 455 455 455 522 555 523 487 455 455 455 455 455 455 455 455 455 522 555 523 423 422 422 422 422 422 657 161
66 657 487 455 582 487 455 455 422 422 422 455 455 455 455 455 455 455 455 455 455 422 422 422 455 455 455 455 455 455 657 161
787 657 487 455 455 455 455 455 620 621 622 487 455 455 455 455 455 455 455 455 455 620 621 622 487 455 455 455 33 33 657 786
819 657 487 455 582 487 455 455 522 555 523 487 455 455 455 455 455 455 455 455 455 522 555 555 458 458 458 458 458 458 656 818
721 657 487 455 455 455 455 455 422 422 422 455 455 455 455 455 455 455 455 455 455 422 422 422 422 422 422 422 422 422 657 721
721 657 487 455 582 487 455 455 625 461 626 487 455 455 448 487 455 448 487 455 455 625 461 626 487 455 455 455 455 455 657 721
721 657 487 455 455 455 455 455 657 527 657 487 455 455 529 487 455 529 487 455 455 657 527 655 458 458 459 484 457 458 656 721
66 657 487 455 582 487 455 455 657 591 352 461 461 461 561 421 421 561 461 461 461 353 591 657 423 422 422 422 422 422 657 161
66 657 487 455 455 455 455 455 657 725 354 525 525 525 561 421 421 561 527 525 525 355 725 657 487 455 455 33 487 455 657 786
721 657 487 455 455 455 455 455 657 725 386 589 589 589 593 421 421 561 591 589 589 387 725 657 487 455 455 455 455 455 657 818
721 352 461 461 461 461 461 461 353 725 724 734 730 724 724 421 421 725 734 66 730 766 730 352 461 461 461 461 461 461 353 161
66 354 525 525 525 525 525 525 355 766 730 766 66 730 724 724 766 730 766 66 729 734 66 354 525 525 525 525 525 525 355 161
66 386 589 589 589 589 589 589 387 734 66 66 66 729 724 766 729 734 66 66 730 766 66 386 589 589 589 589 589 589 387 161
