FE5 - Castle v2 (Blue)
32 32
153 311 311 311 311 311 154 1006 1006 1006 1006 1006 1006 1006 1006 1006 153 311 311 311 311 311 311 311 311 311 311 311 311 311 311 311
153 311 311 311 311 311 277 212 212 212 212 212 212 212 212 212 276 311 311 311 311 311 311 311 311 311 311 311 311 311 311 311
153 311 311 311 311 311 311 311 311 311 311 311 311 311 311 311 311 311 309 244 244 244 244 244 244 244 244 244 244 244 244 244
153 311 311 311 309 244 244 244 244 244 244 244 244 244 244 244 244 244 181 323 398 398 398 398 324 398 324 398 398 324 329 1005
153 311 311 309 181 1005 323 398 398 398 398 398 398 398 398 398 398 324 324 393 717 718 718 718 394 717 394 717 718 387 361 1005
153 311 311 154 492 396 393 950 951 951 951 951 951 951 951 952 718 355 393 717 750 750 750 750 750 750 750 750 750 718 387 329
153 311 311 154 1005 718 718 1014 1015 1015 1015 1015 1015 1015 1015 1016 750 362 717 750 750 750 750 148 338 212 338 149 750 750 718 362
153 311 311 154 492 323 398 398 399 749 396 398 398 324 399 749 396 388 329 749 750 750 148 276 370 823 370 277 149 750 750 362
153 311 311 154 492 362 947 951 951 951 951 951 952 362 947 951 951 952 362 749 750 148 276 338 434 855 434 338 277 149 750 362
153 311 311 154 1005 362 979 983 983 983 983 983 984 362 979 983 983 984 362 749 750 153 311 338 749 981 750 338 311 154 750 362
153 311 311 154 1005 362 979 983 983 983 983 983 984 362 979 983 983 984 362 749 750 180 308 370 749 981 750 370 309 181 750 387
153 311 311 154 1005 362 979 983 983 983 983 983 984 387 329 979 983 984 387 329 749 750 153 434 425 458 459 434 154 950 951 951
153 311 311 154 1005 362 1011 1015 1015 1015 1015 1015 1016 750 362 979 983 886 952 362 749 750 153 149 750 981 750 148 154 982 983 983
153 311 311 154 1005 355 399 749 396 398 329 749 750 750 362 979 983 983 984 362 749 750 180 245 283 981 338 247 181 982 983 983
153 311 311 154 1005 362 947 951 951 952 387 329 947 952 362 979 983 983 984 387 329 947 951 951 951 981 338 749 750 1014 1015 1015
153 311 311 154 1005 362 979 983 983 886 952 362 979 984 362 979 983 983 886 952 387 329 979 983 983 981 370 749 750 750 750 323
153 311 311 154 1005 362 979 983 983 983 984 362 979 984 387 329 979 983 983 886 952 362 1011 1015 1015 1013 434 749 750 750 750 362
153 311 311 154 1005 362 1011 1015 1015 1015 1016 362 1011 1016 750 394 979 983 983 983 984 387 398 398 399 400 396 398 398 398 398 361
153 311 311 154 1005 355 324 399 749 396 398 388 329 749 750 750 982 983 983 983 886 951 951 951 951 951 951 951 951 952 718 362
153 311 311 154 1005 339 362 947 951 951 951 952 387 329 749 750 982 983 983 983 983 983 983 983 983 983 983 983 983 984 323 339
153 311 311 154 1005 371 362 979 556 979 983 983 952 387 329 749 982 983 983 983 983 983 983 983 983 983 983 983 983 984 362 371
153 311 311 154 1005 435 362 556 979 556 979 983 984 750 387 324 398 329 979 983 323 398 329 979 983 983 983 983 983 984 362 435
153 311 311 154 1005 1006 362 979 556 979 556 979 556 749 750 362 683 362 1011 1015 362 683 362 1011 1015 1015 1015 1015 1015 1016 362 973
153 311 311 154 1005 1006 362 556 323 398 398 398 398 398 398 393 715 339 749 750 339 715 387 398 398 398 398 329 749 750 362 1005
153 311 311 154 1005 1006 339 398 339 515 516 517 516 515 516 517 148 371 425 459 371 149 515 516 517 515 516 339 398 398 339 1005
153 311 311 154 1005 1006 371 516 371 579 580 581 580 579 580 581 153 403 425 459 403 154 579 580 581 579 580 371 516 516 371 1005
153 311 311 154 1005 1006 435 580 435 973 974 974 974 974 974 974 1006 974 974 974 974 1006 974 974 974 974 974 435 580 580 435 1005
153 311 311 154 1005 1006 1006 1006 1006 1006 1006 1006 1006 1006 1006 1006 148 149 1006 1006 148 149 1006 1006 1006 1006 1006 974 974 974 974 1006
153 311 311 277 212 212 212 212 212 212 212 212 212 212 212 212 276 154 1006 1006 153 277 212 212 212 212 212 212 212 212 212 212
153 311 311 311 311 311 311 311 311 311 311 311 311 311 311 311 311 154 1006 1006 153 311 311 311 311 311 311 311 311 311 311 311
276 311 311 311 311 311 311 311 311 311 309 244 244 244 244 244 244 181 1006 1006 180 244 244 244 244 244 244 244 244 244 244 244
311 311 311 311 311 311 311 311 311 311 154 1006 1006 1006 1006 1006 1006 1006 1006 1006 1006 1006 1006 1006 1006 1006 1006 1006 1006 1006 1006 1006
