FE5 - Fields (Day)
30 32
212 220 66 66 66 807 808 809 66 636 666 666 605 721 70 114 103 173 132 102 38 38 38 38 114 38 38 38 103 132 53 212
212 212 52 132 132 871 872 873 596 666 666 666 605 721 102 71 69 70 80 69 102 114 103 173 69 102 114 103 66 53 212 212
212 212 212 52 66 66 132 132 636 634 634 666 605 721 721 47 66 102 82 868 82 79 80 69 69 66 66 66 53 212 212 244
245 212 212 212 565 570 34 570 629 772 772 628 635 570 570 570 597 66 47 102 114 103 738 738 66 69 66 53 212 212 244 213
213 245 212 20 721 721 66 721 721 69 721 721 66 66 66 66 2 132 132 132 738 738 738 66 964 66 964 221 212 244 244 213
213 213 212 52 66 625 458 458 458 458 458 458 458 458 626 66 628 570 34 570 570 570 570 570 570 570 566 212 244 244 213 213
213 213 212 220 66 657 423 422 422 422 422 422 422 422 657 626 66 174 38 71 66 69 66 66 66 132 132 221 244 213 213 213
213 277 212 20 721 657 487 455 455 625 353 487 352 461 491 657 66 70 38 81 721 721 66 66 66 66 53 212 213 213 213 213
277 212 20 66 721 657 487 455 455 657 385 421 384 493 493 657 70 38 38 143 66 69 721 66 66 53 212 244 213 213 213 213
245 212 52 165 102 657 487 455 455 657 66 421 66 66 66 490 448 38 103 448 461 626 165 132 53 212 212 213 213 213 213 213
245 245 212 52 69 657 487 455 455 657 729 724 66 66 66 494 529 725 734 529 495 657 725 734 462 626 212 276 213 213 213 213
213 213 212 20 69 657 487 455 455 657 448 725 734 66 66 66 593 725 724 593 725 657 725 724 494 657 212 212 212 276 213 213
213 213 212 52 69 352 461 461 461 353 529 725 724 724 734 66 729 724 724 724 724 657 725 724 724 490 461 626 88 212 276 213
213 277 212 20 112 384 493 493 493 385 593 725 724 724 788 794 788 724 724 724 724 490 626 725 724 494 493 657 165 21 212 276
213 212 20 738 738 110 102 114 103 110 66 730 724 766 66 132 66 795 724 724 766 494 657 725 724 724 724 657 66 165 221 212
277 212 52 69 66 66 66 69 69 836 900 729 796 132 132 66 66 730 766 132 132 69 657 725 724 724 724 490 461 626 21 212
212 212 625 461 461 461 461 461 689 353 69 730 724 352 689 461 461 461 461 461 626 66 657 725 724 724 724 494 493 657 66 221
212 212 657 495 582 549 582 493 657 385 66 729 724 384 657 495 493 493 493 493 490 461 491 725 724 724 724 724 724 657 66 221
625 458 523 423 582 581 582 423 657 734 729 724 724 724 657 725 724 724 724 724 494 493 496 725 724 724 724 724 724 657 66 221
657 423 455 455 422 422 422 455 657 725 724 724 724 724 657 725 724 724 724 724 724 724 724 724 625 433 724 462 461 461 626 21
657 487 455 455 455 455 455 455 657 461 353 724 352 689 491 725 724 724 724 724 724 724 724 724 657 498 484 494 493 493 657 66
657 487 455 455 455 455 455 455 432 495 385 484 384 657 496 725 625 461 461 461 461 461 461 461 491 423 422 422 422 33 657 66
657 487 455 455 455 455 455 455 497 423 422 422 422 657 724 724 657 495 493 493 493 493 493 493 496 487 455 625 461 461 491 66
657 487 455 455 455 455 455 455 455 455 455 455 455 657 724 724 657 423 422 422 422 422 422 422 422 455 455 657 495 493 496 66
657 487 455 455 455 455 455 455 658 487 455 455 455 657 725 724 657 487 33 487 625 461 461 461 461 461 461 491 66 66 53 52
490 461 461 461 461 461 461 461 463 461 461 461 461 491 725 724 490 461 461 461 491 495 493 493 493 493 493 496 738 738 221 212
494 493 493 493 493 493 493 493 493 493 493 493 493 496 725 724 494 493 493 493 496 66 53 117 117 117 117 52 66 53 212 244
52 53 52 119 66 53 52 66 66 53 52 66 66 729 788 766 66 66 66 66 66 53 212 212 212 245 212 212 117 212 244 213
245 245 244 245 117 212 245 117 117 212 212 565 570 570 570 34 570 570 570 566 117 212 212 244 213 213 245 212 212 244 213 213
245 244 213 213 245 244 213 245 212 212 20 66 66 66 66 66 66 772 772 53 212 212 244 213 213 213 213 245 244 213 213 213
