FE5 - Fields (Green)
22 22
944 945 945 913 914 721 608 742 647 711 712 682 682 619 711 711 711 617 717 21 212 212
721 786 787 944 946 35 35 66 710 711 711 712 682 682 619 711 711 718 749 53 212 244
721 818 819 721 66 772 66 608 710 711 711 711 712 682 682 619 718 717 53 212 244 213
787 857 858 859 66 66 608 614 711 711 711 711 711 617 682 682 682 717 21 212 213 213
819 889 890 891 66 608 614 711 711 711 711 711 711 718 682 682 682 717 53 212 276 213
721 921 922 923 35 678 647 711 711 711 711 711 711 712 715 716 617 717 21 87 212 276
66 66 15 66 66 133 742 647 711 711 711 711 711 711 716 711 718 749 66 66 21 212
66 66 102 79 82 71 608 710 711 711 711 711 711 711 711 718 749 66 66 133 133 221
66 66 66 110 110 102 71 742 775 647 711 711 711 711 718 749 133 807 808 809 66 21
721 721 66 133 133 133 47 102 66 742 647 711 711 718 749 37 37 871 872 873 66 66
880 882 804 721 721 614 685 133 868 66 742 647 718 749 35 804 66 66 66 37 37 37
912 914 721 721 678 647 617 685 66 66 14 66 66 66 900 66 804 66 66 804 804 35
944 946 721 609 610 710 648 717 35 35 102 71 78 37 37 70 175 37 66 35 35 15
787 608 609 610 610 710 712 682 685 35 35 102 38 175 35 102 71 78 35 35 70 38
819 609 610 609 610 742 775 712 682 685 37 66 102 71 141 70 38 38 71 70 103 102
609 610 608 609 610 609 610 710 617 749 66 66 66 142 38 38 38 38 103 173 35 35
609 610 614 716 617 685 608 613 718 804 66 66 66 102 38 38 103 102 175 37 133 133
716 716 711 711 648 682 685 608 37 66 37 37 66 106 102 103 66 66 133 133 66 35
711 711 711 711 718 715 617 685 608 133 133 66 37 37 37 37 133 133 66 53 52 53
619 711 711 711 712 619 718 682 685 35 35 772 133 133 133 133 133 133 53 212 212 244
713 619 711 711 711 713 682 715 617 685 133 66 772 772 37 37 37 37 221 212 244 213
718 715 711 711 711 711 713 619 718 749 37 35 35 66 37 66 66 53 212 244 213 213
