FE5 - Castle v2 (Blue)
21 15
362 749 821 823 824 749 362 749 814 750 396 398 399 749 814
362 813 853 855 856 813 362 813 750 814 750 814 750 814 750
387 399 1011 1015 1015 396 393 749 814 320 322 749 814 750 814
718 782 718 782 718 782 718 814 750 352 354 749 750 556 749
814 750 814 750 814 750 323 398 398 389 335 749 814 750 814
750 814 396 398 398 398 393 781 718 782 363 322 749 814 750
814 750 782 718 782 718 782 750 814 750 352 366 322 749 814
750 814 750 814 750 814 320 322 749 814 384 332 354 749 750
814 750 814 750 814 323 389 390 329 749 782 352 354 749 814
750 814 750 814 323 393 717 782 387 329 749 384 359 321 321
814 750 330 749 394 717 814 750 814 362 813 718 384 385 385
750 323 393 813 718 814 750 814 323 393 749 814 718 782 718
323 393 781 556 813 750 320 326 393 717 814 750 814 750 814
393 781 750 814 750 814 352 354 717 814 750 814 750 814 750
782 750 814 750 320 326 389 386 813 750 814 750 814 750 323
750 814 320 326 389 386 717 782 750 814 750 814 323 398 393
398 398 389 386 781 718 814 822 813 750 814 750 362 717 782
718 782 718 782 750 814 750 784 822 813 750 323 393 813 750
814 750 814 750 814 750 814 750 784 323 398 393 781 750 814
750 814 750 814 750 814 750 814 750 362 717 782 750 814 750
814 750 814 750 814 750 814 750 320 367 813 750 814 750 814
