FE5 - Plains v2 Alt
32 32
802 802 802 802 802 802 802 802 962 962 929 928 802 802 802 802 802 802 802 802 802 802 802 802 802 802 802 802 802 802 802 802
802 802 802 802 802 802 802 933 384 384 416 256 928 802 802 802 802 802 802 802 802 802 802 802 802 802 802 962 962 962 802 802
802 802 802 802 802 802 802 933 448 68 68 256 68 928 962 802 802 802 802 802 802 802 802 802 802 802 929 68 68 68 928 802
802 802 802 982 824 983 802 802 897 994 68 68 68 68 68 928 962 962 929 928 962 962 802 802 802 929 68 740 740 68 68 901
802 802 929 952 854 953 929 928 928 802 897 68 68 68 68 68 68 68 68 68 68 68 928 962 929 648 207 68 68 68 68 901
802 933 68 984 886 985 68 247 246 928 962 994 994 994 897 68 68 740 740 68 68 68 68 68 334 850 851 852 68 68 896 962
802 802 897 68 68 68 247 212 214 68 68 928 802 802 802 897 68 68 68 740 740 68 68 68 68 914 915 916 68 896 933 68
962 962 802 897 68 648 215 214 68 68 68 68 901 802 802 802 897 68 68 68 740 740 740 68 68 994 68 68 896 802 802 994
68 68 928 802 994 994 648 648 68 68 68 896 802 802 802 802 802 994 994 994 994 994 994 994 994 802 897 648 68 901 648 802
994 897 68 901 962 962 962 994 994 994 994 802 802 802 802 802 802 802 802 802 962 802 802 802 802 802 933 68 68 901 802 802
802 802 994 933 68 68 68 928 802 802 802 802 802 802 802 802 802 802 802 933 648 901 962 962 802 802 802 897 68 928 802 802
802 933 68 901 897 68 68 68 901 802 802 802 802 802 802 802 802 802 802 802 994 933 648 68 928 802 802 933 68 68 928 962
802 929 68 901 802 994 994 994 802 802 802 802 802 802 802 802 802 802 802 802 802 802 994 897 648 901 802 929 68 68 68 68
933 68 608 928 962 962 802 802 962 962 962 802 802 802 802 802 802 802 802 802 802 802 802 802 994 802 933 68 994 896 994 994
802 897 68 68 68 68 928 929 68 68 68 928 802 802 802 802 802 802 802 802 802 802 802 802 802 802 802 994 962 962 962 962
802 802 994 994 897 68 68 68 68 198 199 207 901 802 802 802 802 802 802 802 802 802 802 802 802 802 962 929 68 68 740 740
802 802 802 802 802 994 994 897 236 337 337 231 901 802 802 802 802 802 802 802 802 802 802 802 802 929 68 68 68 68 68 648
802 802 802 802 802 802 802 933 68 230 333 896 802 802 802 802 802 802 802 802 802 802 802 802 929 68 68 68 648 333 68 68
802 802 802 802 802 802 802 802 897 68 68 901 962 962 962 962 962 962 962 962 802 802 802 929 68 648 770 68 337 337 199 198
802 802 802 802 802 802 802 802 933 596 569 38 569 569 569 569 569 569 569 597 901 802 929 68 68 198 367 199 366 337 337 335
802 802 802 802 802 802 802 802 933 632 68 68 68 68 68 68 68 256 68 632 901 929 68 68 334 231 239 230 337 335 231 68
802 802 802 802 802 802 802 802 933 632 68 68 207 198 367 199 68 238 68 632 929 68 805 740 68 68 68 68 68 648 68 648
802 802 802 802 802 802 802 802 933 632 68 68 230 231 238 239 68 68 68 2 68 68 68 68 648 68 68 648 68 68 68 68
962 962 962 962 929 928 802 802 933 632 68 68 68 770 805 740 68 68 68 632 68 68 68 68 68 68 247 313 38 313 313 313
569 569 569 569 569 597 928 962 929 632 68 68 608 68 68 68 68 68 68 314 313 313 313 313 313 989 957 958 1019 956 957 990
68 68 68 68 68 628 569 569 569 634 569 38 569 569 569 569 569 569 119 212 212 212 212 212 280 991 987 988 1020 33 987 991
648 68 68 68 68 68 68 68 68 68 68 68 68 68 68 68 68 68 215 212 212 212 212 212 280 991 1019 33 1019 1020 1020 991
68 68 804 770 805 740 804 68 198 367 199 268 269 68 68 68 68 68 247 212 244 213 245 212 280 1021 957 957 957 957 957 1022
770 805 68 68 68 68 68 68 335 337 337 337 337 199 68 68 68 247 212 244 213 213 213 245 280 1016 1017 1017 1017 1017 1017 1018
198 367 199 268 269 68 770 805 68 230 337 231 238 239 68 68 247 212 244 213 213 213 213 213 245 313 313 313 313 313 313 313
68 68 68 68 68 68 68 68 68 68 68 68 68 68 68 247 212 244 213 213 213 213 213 213 213 245 212 212 244 245 212 212
68 68 68 68 68 68 68 68 68 68 68 68 68 68 247 212 244 213 213 213 213 213 213 213 213 213 245 244 213 213 245 212
