FE5 - Fields (Dark)
10 15
0 749 742 617 749 721 721 721 70 38 114 80 66 710 0
0 674 868 719 66 721 721 112 38 103 868 66 66 742 0
0 141 15 66 66 66 66 66 46 66 66 998 772 772 0
0 38 103 66 477 570 570 478 868 631 570 535 868 998 0
0 38 80 868 998 66 66 70 80 510 66 600 66 53 0
0 103 66 998 66 66 568 47 66 66 631 634 570 666 0
0 998 66 66 477 570 629 868 477 570 629 66 15 25 0
0 721 673 674 66 66 66 238 66 14 66 70 81 15 0
0 653 721 721 66 66 998 66 112 114 82 38 111 103 0
0 682 653 721 614 716 716 716 681 653 102 81 614 716 0
