FE5 - Fields (Dark)
10 15
0 0 0 0 0 0 0 0 0 0 0 0 0 0 0
0 0 80 66 738 738 657 518 454 454 454 454 454 0 0
0 0 721 70 71 15 657 518 582 518 454 582 518 0 0
0 0 46 102 111 103 657 518 454 454 454 454 454 0 0
0 0 285 286 457 458 523 518 454 625 459 454 454 0 0
0 0 454 454 454 454 454 454 454 657 318 14 317 0 0
0 0 317 454 454 454 454 454 454 657 70 143 66 0 0
0 0 721 66 317 454 454 317 454 657 172 173 66 0 0
0 0 66 66 66 317 721 721 317 657 66 15 721 0 0
0 0 0 0 0 0 0 0 0 0 0 0 0 0 0
