FE5 - Fields (Dark)
10 15
0 0 0 0 0 0 0 0 0 0 0 0 0 0 0
0 0 71 998 721 721 721 600 66 66 66 66 721 0 0
0 0 38 71 66 66 66 632 79 71 66 66 66 0 0
0 0 38 38 82 71 66 2 38 38 71 140 78 0 0
0 0 102 111 38 143 66 632 38 114 38 38 114 0 0
0 0 66 66 102 103 596 598 47 66 102 143 721 0 0
0 0 66 66 66 66 2 66 66 66 70 81 70 0 0
0 0 653 66 66 596 598 14 66 66 47 102 103 0 0
0 0 650 653 66 632 70 38 71 772 772 721 66 0 0
0 0 0 0 0 0 0 0 0 0 0 0 0 0 0
