FE5 - Fields (Green)
12 16
0 66 721 721 721 719 66 66 721 721 721 721 772 772 66 0
0 70 71 721 66 66 741 772 721 66 66 772 66 772 772 0
0 142 38 71 66 66 721 66 66 772 772 66 66 66 646 0
0 47 102 38 71 66 66 868 66 721 70 79 80 66 742 0
0 80 66 142 721 721 15 66 66 70 38 38 71 15 721 0
0 66 112 38 38 82 38 71 70 38 103 47 721 143 66 0
0 721 70 38 868 111 38 38 38 38 71 66 70 103 112 0
0 71 102 111 81 721 47 102 721 143 721 70 143 721 66 0
0 103 66 721 46 773 773 721 142 38 82 903 904 905 66 0
0 721 736 66 66 721 721 721 721 111 721 967 968 969 66 0
0 786 787 773 70 71 721 140 141 721 721 102 103 102 709 0
0 818 819 721 786 787 998 102 38 77 70 71 66 646 716 0
