FE5 - Castle v2 (Blue)
20 15
0 0 323 398 398 398 398 589 398 398 398 398 329 0 0
0 0 362 973 974 982 983 855 983 984 974 974 362 0 0
0 0 362 1005 1006 1014 1015 1015 1015 1016 1006 1006 362 0 0
0 0 362 1005 1006 982 983 981 983 984 1006 1006 362 0 0
0 0 355 398 399 982 983 981 983 984 396 398 361 0 0
0 0 362 973 1006 982 983 981 983 984 974 974 362 0 0
0 0 362 1005 822 982 983 981 983 984 822 1005 362 0 0
0 0 362 1005 976 982 320 321 322 980 976 975 362 0 0
0 0 362 1005 1006 982 384 385 386 980 1006 1006 362 0 0
0 0 362 1005 822 982 983 981 983 984 822 1005 362 0 0
0 0 362 1005 976 982 983 981 983 984 976 1006 362 0 0
0 0 355 398 399 982 983 981 983 984 396 398 361 0 0
0 0 362 973 974 982 983 981 983 984 974 974 362 0 0
0 0 362 1005 822 982 983 981 983 984 822 1005 362 0 0
0 0 362 1005 976 982 320 321 322 980 976 1006 362 0 0
0 0 362 1005 1006 982 384 385 386 980 1006 1006 362 0 0
0 0 362 1005 822 982 983 981 983 984 822 1005 362 0 0
0 0 362 1005 976 982 983 981 983 984 976 1006 362 0 0
0 0 362 1005 1006 982 983 981 983 984 1006 1006 362 0 0
0 0 355 398 398 982 396 398 399 980 396 398 361 0 0
