FE5 - Fields (Dark)
10 15
0 0 0 0 0 0 0 0 0 0 0 0 0 0 0
0 0 721 102 38 38 71 706 801 172 173 675 676 0 0
0 0 676 66 103 172 173 66 868 801 66 66 721 0 0
0 0 66 66 66 14 70 79 80 66 66 66 801 0 0
0 0 66 66 112 114 38 38 82 71 14 66 721 0 0
0 0 801 721 721 112 38 38 38 38 38 868 66 0 0
0 0 70 79 80 721 81 46 102 38 103 66 66 0 0
0 0 38 38 71 15 721 66 66 46 66 66 66 0 0
0 0 38 38 38 103 738 66 66 66 70 721 721 0 0
0 0 0 0 0 0 0 0 0 0 0 0 0 0 0
