FE5 - Fields (Dark)
10 15
66 113 38 71 66 66 66 66 66 66 66 66 66 66 66
66 102 38 81 66 66 66 66 66 66 66 66 66 66 66
66 66 102 38 71 66 66 70 82 79 79 71 66 66 66
66 66 66 102 38 71 70 38 38 38 38 38 71 66 66
66 66 66 66 113 38 38 38 38 38 38 38 143 66 66
66 66 66 66 102 38 38 38 38 38 38 38 81 66 66
66 66 66 66 66 102 38 38 38 38 38 38 103 66 66
66 66 66 66 66 66 102 111 103 102 114 103 66 66 66
66 66 66 66 66 66 66 66 66 66 66 66 66 66 66
66 66 66 66 66 66 66 66 66 66 66 66 66 66 66
