FE5 - Fields (Dark)
10 15
0 0 0 0 0 0 0 0 0 0 0 0 0 0 0
0 0 38 71 721 66 70 38 71 721 66 66 66 0 0
0 0 38 103 66 721 113 38 868 66 66 66 66 0 0
0 0 721 721 66 66 102 38 71 66 66 66 66 0 0
0 0 738 721 721 66 721 721 103 66 66 66 721 0 0
880 881 882 721 66 721 66 46 66 66 66 868 66 0 0
912 913 914 66 66 66 721 66 721 721 66 66 66 0 0
944 945 946 721 721 66 721 721 66 66 66 66 66 0 0
0 0 786 787 66 721 786 787 786 787 721 66 66 0 0
0 0 818 819 0 0 818 819 818 819 0 0 0 0 0
