FE5 - Fields
28 32
213 213 213 277 315 276 213 213 213 213 213 213 213 277 20 21 276 213 213 213 213 213 245 20 21 88 276 213 213 213 213 213
213 213 277 214 316 215 276 213 213 213 213 213 277 20 163 804 21 89 276 213 213 245 20 721 196 53 244 213 213 213 213 213
213 277 214 316 316 316 215 276 213 213 213 277 20 163 721 721 721 66 21 276 213 212 52 196 53 244 213 213 213 213 213 213
283 214 177 177 316 316 316 215 276 213 213 212 118 66 163 163 721 163 219 89 276 212 220 53 20 21 276 213 213 213 213 213
300 301 66 66 238 238 296 316 215 276 277 212 20 163 163 738 738 738 721 163 21 276 212 20 66 721 21 276 213 213 213 213
79 71 721 66 78 66 234 294 316 314 212 20 70 43 80 66 66 165 738 721 219 213 20 807 808 809 66 21 276 213 213 213
38 38 71 70 868 71 163 66 238 7 9 66 113 625 458 626 721 165 165 66 66 2 163 871 872 873 66 196 221 276 213 213
38 38 103 102 38 38 71 163 66 116 118 658 731 657 33 522 458 458 458 626 734 221 218 196 119 116 34 116 212 212 213 213
38 38 175 112 114 38 81 163 219 212 90 657 484 657 423 455 455 455 33 657 796 21 52 53 212 20 163 21 20 21 276 213
38 103 107 132 132 102 103 196 53 244 122 554 726 522 458 458 484 458 458 523 796 53 212 212 212 218 738 738 721 219 212 213
102 107 196 53 52 197 196 53 244 213 245 52 730 788 724 788 766 66 66 582 796 21 89 212 212 52 163 721 196 116 244 213
132 196 53 244 245 52 53 244 277 276 213 245 52 163 828 163 163 163 163 729 582 582 734 21 212 20 165 196 55 244 213 213
196 53 244 213 213 245 244 277 84 86 276 245 220 66 828 66 66 66 729 582 582 725 766 7 9 66 196 116 244 213 213 213
53 244 213 213 213 213 277 20 721 81 21 277 20 729 796 66 66 132 582 582 725 766 55 88 213 52 55 88 276 213 213 213
244 213 213 213 277 89 20 70 38 111 7 9 757 788 766 132 582 582 582 725 766 55 20 163 221 88 20 163 21 88 276 213
213 213 213 277 20 70 82 114 103 53 212 89 118 197 69 582 582 725 788 766 55 20 721 66 2 66 66 132 66 66 91 276
213 213 277 20 66 102 103 868 71 21 20 66 91 52 582 582 725 766 119 55 20 738 738 116 212 52 625 484 626 734 123 212
213 277 220 66 66 721 70 38 721 75 721 196 123 212 52 119 69 868 21 20 163 66 66 221 212 220 657 423 657 796 21 212
277 212 220 66 66 857 858 859 38 137 721 55 214 215 212 20 66 66 69 738 738 163 163 21 212 20 657 33 657 796 66 21
277 212 220 163 70 921 922 923 38 38 103 2 230 316 215 52 197 738 738 163 69 66 66 66 2 163 657 423 657 830 66 165
245 212 20 69 721 103 69 163 102 103 53 220 163 230 177 215 52 66 738 738 66 69 69 219 90 132 522 458 523 165 196 55
213 245 52 197 102 721 53 52 119 119 221 212 52 163 721 238 2 66 163 66 116 54 69 219 122 66 66 66 66 196 55 212
213 213 245 52 197 196 221 212 84 85 85 86 212 52 163 163 221 52 53 117 213 89 54 116 212 54 197 900 116 117 212 212
213 213 213 245 52 53 244 245 52 868 721 53 84 86 52 55 212 212 212 89 20 66 21 84 86 212 54 116 212 84 85 86
213 213 213 213 245 244 213 213 245 52 53 220 197 721 21 212 212 89 20 868 132 868 721 721 55 212 212 212 90 868 721 55
213 213 213 213 213 213 213 213 213 213 213 245 52 868 66 91 212 54 197 238 721 238 196 55 244 213 213 245 122 238 55 244
213 213 213 213 213 213 213 213 213 213 213 213 245 52 197 123 244 245 54 119 119 119 55 244 213 213 213 213 245 117 244 213
213 213 213 213 213 213 213 213 213 213 213 213 213 245 117 244 213 213 245 212 212 212 244 213 213 213 213 213 213 245 213 213
