FE5 - Castle v2 OG (Dark)
28 28
878 878 878 878 362 877 878 878 878 878 878 878 878 878 878 878 878 878 878 878 394 845 846 846 846 846 846 846
878 878 878 878 394 877 878 878 878 878 878 878 878 878 878 878 878 878 878 878 878 878 878 556 877 878 878 878
878 878 878 878 878 878 878 878 878 878 878 878 878 878 878 878 878 878 878 878 330 877 878 878 878 878 878 878
878 556 878 878 330 877 878 339 395 398 399 877 878 878 396 398 398 339 877 878 355 398 398 398 398 398 398 398
878 878 878 323 393 877 878 371 640 641 642 425 458 459 640 641 642 371 877 878 394 845 846 846 846 846 846 846
398 398 398 393 845 878 878 330 973 974 974 457 458 459 973 974 974 330 877 878 878 878 878 878 878 878 878 878
846 846 846 846 878 878 878 362 1005 1006 1006 974 974 974 1006 1006 1006 362 877 878 330 877 878 878 878 878 878 878
878 878 878 878 878 878 878 362 1005 1006 950 951 951 952 1006 1006 1006 362 877 878 355 398 398 398 398 398 398 398
398 398 339 877 323 398 398 388 339 1005 982 983 983 886 951 952 1006 362 877 878 394 845 846 846 846 846 846 846
846 846 371 877 362 845 846 846 371 1005 982 983 983 983 983 984 1006 362 877 878 878 878 878 878 878 878 556 877
878 878 330 877 387 329 877 878 330 1005 982 983 983 983 983 984 1006 362 877 878 330 877 878 878 878 878 878 878
878 878 339 877 878 362 877 878 362 1005 982 983 983 983 983 984 1006 362 877 878 387 398 398 398 398 398 398 398
878 878 371 877 323 393 877 878 362 1005 982 983 983 983 983 984 1006 339 877 878 846 846 846 846 846 846 846 846
878 878 330 877 362 845 878 878 362 1005 1014 1015 1015 1015 1015 1016 1006 371 877 878 878 878 878 878 878 878 878 878
878 878 339 877 387 329 878 878 362 1005 1006 1006 1006 1006 1006 1006 1006 320 321 321 321 321 321 321 321 321 321 321
878 878 371 877 846 362 878 878 362 1005 1006 1006 1006 1006 1006 1006 1006 384 385 385 385 385 385 385 385 385 385 385
878 878 330 877 323 393 878 878 339 1005 1006 1006 1006 1006 1006 1006 1006 974 974 974 974 974 974 974 974 974 974 974
878 878 339 877 362 845 878 878 371 320 321 321 321 339 1005 1006 1006 1006 1006 1006 1006 1006 1006 1006 1006 1006 1006 1006
878 878 371 877 362 877 878 878 396 389 385 385 385 371 1005 1006 1006 1006 1006 1006 1006 1006 1006 1006 1006 1006 1006 1006
398 398 399 877 339 877 878 878 878 878 878 878 878 320 321 321 321 321 321 321 321 321 321 321 321 321 321 321
846 846 846 878 371 877 878 878 878 878 878 878 878 384 385 385 385 385 385 385 365 385 385 385 385 385 385 385
878 878 878 878 396 398 398 398 398 398 399 877 878 846 846 846 846 846 846 846 362 845 846 822 823 822 845 846
398 329 878 878 846 846 846 846 846 846 846 878 878 878 878 878 878 878 878 878 394 877 878 853 855 856 877 878
846 387 329 878 878 878 878 878 878 878 878 878 878 323 398 398 398 329 877 878 846 878 878 457 458 459 877 878
878 846 387 398 398 398 398 398 398 398 329 877 878 362 845 878 878 362 877 878 878 878 878 878 878 878 878 878
878 556 845 846 846 846 846 846 846 846 394 877 878 362 877 878 878 387 398 398 399 877 878 878 878 878 878 878
878 878 878 878 878 878 878 878 878 878 878 878 878 362 877 556 877 878 878 878 878 878 878 878 878 878 878 878
878 878 878 878 878 878 878 878 878 878 330 877 878 362 877 878 878 878 878 878 330 877 878 878 878 878 878 878
