FE5 - Fields
32 22
213 213 213 213 52 66 66 66 142 38 38 38 38 38 114 38 71 66 710 711 617 682
213 213 213 213 20 66 66 70 38 38 38 860 858 861 71 142 81 66 742 775 712 682
277 276 213 213 52 162 70 38 38 38 38 892 890 893 81 102 103 66 66 710 711 617
212 87 276 213 20 69 113 38 103 102 38 924 922 925 103 66 738 738 738 710 711 718
20 162 21 276 52 162 113 103 66 66 47 113 71 162 66 721 66 69 69 710 718 682
69 868 66 221 20 66 868 71 868 162 162 113 81 66 786 787 69 66 678 711 712 682
69 69 53 220 69 69 102 103 66 66 70 38 38 71 818 819 721 66 742 775 711 712
119 53 244 212 565 570 570 34 570 535 113 81 102 721 880 881 882 66 66 66 742 775
212 244 245 220 66 66 162 15 66 600 47 113 71 721 912 913 914 162 807 808 809 66
21 276 213 245 52 69 69 113 80 600 66 47 113 721 944 945 946 71 871 872 873 66
66 21 276 213 245 52 162 102 71 628 535 70 103 69 721 721 102 114 103 66 66 998
738 738 21 276 277 20 162 112 114 71 600 102 80 69 678 716 617 653 66 66 612 612
71 868 53 212 212 52 162 69 70 81 2 162 162 998 710 711 712 715 716 716 617 653
113 80 21 212 212 20 738 738 113 103 600 66 66 162 742 775 775 649 619 711 718 682
47 868 66 221 20 738 738 868 111 71 628 570 535 66 162 69 66 710 649 619 712 682
66 66 53 212 52 162 69 70 82 38 82 71 600 66 807 808 809 710 711 649 619 712
66 53 212 212 20 162 112 81 102 114 38 103 600 162 871 872 873 742 711 712 651 711
117 212 212 220 66 738 738 47 596 570 34 570 605 66 66 66 66 66 742 775 712 619
245 212 212 212 565 571 570 571 629 70 81 66 628 570 570 570 535 69 66 66 742 712
213 213 245 220 69 69 69 70 82 38 81 66 66 66 66 66 600 572 197 66 66 742
276 213 213 245 52 69 112 114 38 81 47 69 721 69 66 572 604 666 602 34 570 538
21 276 213 213 245 52 66 66 102 786 787 738 738 66 542 666 629 573 573 66 709 868
66 21 276 213 245 20 66 69 721 818 819 71 66 162 162 600 69 69 69 646 712 653
738 738 21 276 245 52 69 69 102 38 81 113 82 71 596 629 66 66 66 710 711 744
71 738 738 21 212 212 52 66 66 113 103 47 102 103 600 66 66 66 66 742 647 647
38 868 66 219 212 212 212 565 570 34 570 571 570 571 629 66 678 716 716 617 653 162
38 103 66 53 244 212 20 69 66 66 66 66 66 66 66 66 710 711 711 718 682 653
47 66 53 244 212 212 52 69 174 82 71 15 66 66 15 66 742 775 711 716 617 682
66 53 244 213 277 88 20 69 70 38 38 786 787 786 787 721 162 162 710 711 712 682
117 244 213 277 20 162 66 70 38 38 721 818 819 818 819 70 82 71 742 775 775 712
244 213 277 20 66 162 112 38 38 868 38 71 112 81 102 114 103 113 80 66 66 742
213 277 212 52 162 162 70 38 38 38 38 81 162 113 135 78 141 46 162 162 162 162
