FE5 - Fields
25 32
711 711 711 711 711 711 711 711 711 712 682 619 711 711 711 711 711 711 711 711 711 711 711 711 711 711 711 711 711 711 711 711
775 775 775 775 775 775 775 775 775 775 712 682 619 775 775 775 775 775 775 775 775 775 775 775 775 775 775 775 775 711 711 711
101 66 162 162 66 66 66 66 66 162 742 617 717 721 721 721 721 721 721 721 721 721 721 721 721 721 721 721 998 710 711 711
101 66 66 162 162 162 162 66 162 162 66 742 749 998 738 738 112 82 71 66 101 101 15 165 162 738 738 738 721 710 711 711
101 738 738 112 82 868 66 162 738 738 738 162 76 868 868 165 66 102 38 79 71 70 38 79 71 66 101 66 721 710 711 711
738 738 738 66 868 38 868 77 66 66 66 66 112 103 612 612 721 112 103 102 38 38 38 38 81 165 738 738 721 710 711 718
101 101 868 66 102 103 102 71 868 738 738 738 738 738 165 614 653 721 721 162 102 103 102 114 38 71 165 721 614 711 718 682
66 101 238 66 845 939 939 847 103 15 66 66 868 66 165 710 716 617 653 721 721 721 721 66 102 38 71 721 710 711 716 617
66 868 66 66 877 971 971 879 70 868 80 66 238 66 165 710 711 718 715 716 716 617 653 721 165 168 103 721 710 711 711 718
112 38 71 70 909 910 910 911 114 103 66 66 868 66 165 710 711 617 715 775 775 718 749 721 101 136 175 721 710 711 711 617
66 102 868 103 110 102 81 66 868 66 66 66 238 66 165 619 775 718 749 721 721 721 721 101 70 38 175 721 710 711 711 648
66 66 238 66 868 70 868 79 38 80 66 66 66 165 614 749 721 721 721 165 112 82 71 70 38 38 71 721 710 711 711 648
66 738 738 738 238 868 102 38 103 101 101 101 101 614 749 721 165 174 82 80 165 102 111 111 103 102 103 721 710 711 711 718
66 738 738 162 162 238 101 102 80 162 162 614 653 719 721 78 78 70 103 101 721 721 721 721 868 582 729 582 742 711 718 682
653 101 66 162 162 66 66 101 101 998 614 718 749 721 162 113 103 110 66 721 998 612 612 612 612 721 828 786 787 742 712 682
682 715 716 716 716 716 716 716 617 653 742 749 721 162 70 103 162 162 721 614 653 964 721 66 964 66 828 818 819 721 742 712
715 716 718 775 775 775 775 775 718 749 786 787 721 162 113 175 66 721 998 742 749 795 734 116 117 118 795 724 734 786 787 742
716 718 749 721 721 721 721 721 721 721 818 819 721 70 103 66 721 614 617 685 721 795 965 221 212 220 965 724 796 818 819 721
718 749 721 721 165 738 738 70 82 79 71 162 70 103 165 721 66 710 718 749 721 795 766 21 87 20 730 724 796 721 786 787
749 721 721 738 738 165 70 38 38 38 38 82 103 66 165 721 614 718 717 994 721 965 731 734 964 734 729 724 796 721 818 819
786 787 738 738 14 70 38 38 38 38 38 786 787 721 721 721 710 617 717 994 721 730 724 724 724 837 837 730 792 880 881 882
818 819 162 70 38 38 38 103 102 103 102 818 819 721 614 716 716 718 717 994 721 721 791 724 724 997 807 808 809 912 913 914
721 66 70 38 38 38 103 162 738 738 162 721 721 614 711 711 718 682 717 928 896 721 721 730 901 901 871 872 873 944 945 946
721 112 38 38 38 38 71 66 66 66 738 738 721 742 711 711 712 682 682 685 928 994 896 721 101 101 66 101 786 787 786 787
721 165 102 38 38 38 38 71 70 82 79 71 721 614 711 711 711 617 715 716 617 685 928 896 786 787 786 787 818 819 818 819
