FE5 - Castle v2 OG (Dark)
30 16
398 398 399 877 878 396 398 398 823 398 399 877 878 396 398 398
878 878 878 878 878 846 822 822 855 822 822 877 878 846 846 846
330 877 878 878 878 878 848 848 878 848 848 847 878 878 878 330
362 877 878 878 878 878 878 878 878 878 878 878 878 878 878 362
362 877 323 398 398 398 398 398 398 398 398 398 398 329 877 362
362 877 362 845 822 845 846 556 588 845 822 845 846 362 877 362
394 877 387 400 398 398 398 398 398 398 398 398 400 393 877 394
846 878 846 846 846 846 846 846 846 846 846 846 846 846 878 846
323 398 398 398 398 398 329 877 878 323 398 398 398 398 398 329
362 845 556 845 556 845 362 877 878 362 845 846 846 846 846 362
387 398 398 400 398 398 393 877 878 387 398 398 400 398 398 393
846 846 846 846 846 846 846 878 878 846 846 846 846 846 846 846
323 398 398 398 398 398 329 877 878 323 398 398 398 398 398 329
362 845 846 846 846 846 362 877 878 362 845 556 845 556 845 362
387 398 398 400 398 398 393 877 878 387 398 398 400 398 398 393
846 846 846 846 846 846 846 878 878 846 846 846 846 846 846 846
323 398 398 398 398 398 329 877 878 323 398 398 398 398 398 329
362 845 556 845 556 845 362 877 878 362 845 846 846 846 846 362
387 398 398 400 398 398 393 877 878 387 398 398 400 398 398 393
846 846 846 846 846 846 846 878 878 846 846 846 846 846 846 846
323 398 398 398 398 398 329 877 878 323 398 398 398 398 398 329
362 845 846 846 846 846 362 877 878 362 845 556 845 556 845 362
387 398 398 400 398 398 393 877 878 387 398 398 400 398 398 393
846 846 846 846 846 846 846 878 878 846 846 846 846 846 846 846
878 878 878 878 878 878 878 878 878 878 878 878 878 878 878 878
878 338 878 878 878 878 878 878 878 878 878 878 878 878 338 878
339 370 339 457 458 458 458 458 458 458 458 458 459 339 370 339
467 402 467 1 2 2 2 2 2 2 2 2 2 467 402 467
2 434 1 35 532 504 504 504 533 532 533 532 565 2 434 1
35 35 35 532 536 536 536 536 536 536 536 536 533 35 35 35
