FE5 - Fields (Day)
32 32
213 212 20 66 112 114 103 172 173 102 114 103 66 21 212 20 120 21 212 218 66 102 38 71 120 120 120 120 21 212 212 276
212 212 218 164 140 141 140 141 140 141 15 66 66 53 20 66 66 66 21 52 66 66 113 38 71 66 66 66 69 21 212 212
245 220 66 112 868 38 868 38 868 38 868 66 53 212 52 130 804 130 130 21 52 130 102 114 38 79 82 71 69 66 120 120
213 212 52 119 66 102 103 46 102 103 66 219 212 212 212 52 46 66 66 7 8 9 130 130 102 114 38 81 737 740 738 66
213 245 212 212 52 119 119 4 53 52 4 53 20 21 212 212 52 66 66 219 212 20 738 738 738 66 102 38 82 71 66 164
213 213 245 212 212 212 212 68 26 21 68 20 66 66 21 20 21 218 66 219 212 218 130 721 738 738 721 38 721 38 71 66
213 213 213 212 212 20 120 69 69 69 164 66 66 66 66 66 66 130 130 53 212 218 721 130 130 721 69 721 114 38 38 71
213 277 212 212 20 69 70 80 721 66 69 69 164 66 66 53 52 130 53 212 212 52 66 738 738 164 119 130 66 113 38 81
277 212 20 120 66 721 81 130 807 808 809 807 808 809 53 212 212 52 221 212 20 21 52 119 119 53 212 52 66 102 38 721
212 20 66 66 70 38 38 71 871 872 873 871 872 873 21 212 212 212 212 20 130 164 21 212 212 212 212 212 52 66 102 80
212 218 66 721 113 103 102 114 80 66 721 66 69 66 219 212 20 120 120 66 738 738 66 21 212 212 212 212 20 66 721 66
212 218 66 112 103 69 130 673 741 772 673 738 738 66 53 212 52 130 164 845 846 847 66 69 21 212 212 20 66 66 66 721
212 218 66 721 130 219 52 130 66 721 130 119 119 119 221 212 212 52 130 877 878 879 66 69 219 220 120 738 738 66 721 66
220 66 66 130 130 66 221 52 119 119 53 212 212 212 212 212 212 20 164 909 910 911 130 69 219 220 66 66 66 66 738 738
212 52 130 66 66 66 221 212 212 212 20 120 120 120 21 212 212 52 66 70 175 738 738 66 66 21 52 66 66 66 119 119
212 212 218 66 721 53 212 20 120 120 164 69 69 66 219 212 212 20 66 113 71 721 69 130 130 53 212 52 868 53 212 212
212 212 218 721 53 212 212 218 69 804 66 804 804 130 219 212 20 738 738 113 38 80 164 66 66 221 212 212 34 212 212 213
212 20 66 66 21 212 20 66 164 238 69 996 238 69 219 212 52 69 66 102 38 71 164 66 53 212 625 458 484 458 626 276
20 66 721 66 66 21 52 164 738 741 69 238 804 804 66 21 212 52 69 70 868 868 71 164 221 212 657 423 422 422 657 212
66 74 77 140 75 69 21 52 66 900 69 836 804 238 66 66 221 212 218 69 102 38 103 130 221 625 523 487 455 455 657 212
74 70 82 38 71 130 53 20 130 900 77 836 66 66 66 66 221 220 66 69 130 47 69 53 212 657 423 455 455 625 491 212
106 113 81 110 102 219 212 52 66 113 175 66 66 66 66 53 212 212 52 119 4 119 53 212 212 657 487 455 455 657 498 212
66 102 38 71 66 219 212 212 218 142 71 738 738 66 53 212 212 212 212 212 68 212 212 212 212 657 487 455 455 657 212 212
52 164 102 38 80 219 212 220 66 102 81 130 130 53 212 212 212 212 212 20 66 120 21 212 212 657 487 455 455 657 212 244
212 218 66 102 71 219 212 212 52 119 4 119 53 212 212 212 20 21 20 164 164 164 164 21 212 490 461 484 461 491 212 213
212 52 66 66 113 71 21 212 212 212 68 212 212 212 212 20 69 66 66 74 141 130 66 721 21 494 496 36 494 496 212 213
245 212 52 164 102 81 164 120 120 120 69 120 21 212 20 69 786 787 102 136 73 141 130 868 721 21 212 68 212 212 244 213
213 212 212 52 66 47 130 66 66 78 15 69 69 21 52 66 818 819 66 113 38 38 71 721 130 130 120 66 21 212 213 213
213 245 212 212 52 721 74 70 82 38 38 71 130 7 9 66 66 66 70 38 114 111 114 103 66 721 130 130 53 212 213 213
213 213 212 212 20 66 106 721 786 787 47 721 80 21 52 66 66 112 114 103 66 66 106 107 69 66 66 53 212 212 213 213
213 213 212 220 66 66 66 721 818 819 66 721 66 53 212 52 66 673 741 772 66 66 66 66 66 66 53 212 212 244 213 213
213 213 245 212 52 66 786 787 78 721 15 66 53 212 212 220 66 66 66 66 66 66 66 66 66 53 212 244 213 213 213 213
