FE5 - Fields
22 32
650 685 66 66 742 711 711 711 718 619 711 711 718 682 715 711 718 682 682 749 742 711 711 711 711 711 711 718 682 715 711 718
617 650 685 66 66 710 711 711 617 682 619 711 648 715 711 718 682 682 749 608 608 742 775 775 775 775 711 744 682 619 711 617
718 650 749 130 66 742 711 711 648 682 683 775 777 683 775 777 682 749 130 130 66 608 608 608 608 608 742 775 744 682 619 718
650 749 608 130 900 130 742 775 777 750 749 721 132 721 66 131 66 66 721 868 130 130 66 131 131 721 608 608 710 716 617 682
717 608 608 66 66 132 132 612 131 721 164 164 721 132 721 678 681 653 612 238 66 131 612 612 132 130 608 608 710 711 712 682
717 608 608 721 130 608 608 131 66 678 716 716 681 653 164 710 718 781 608 132 130 131 130 608 612 132 132 608 710 711 711 617
717 608 721 130 721 132 66 131 608 710 652 679 718 651 716 681 717 608 130 132 132 132 132 164 608 612 164 608 742 711 711 718
717 608 721 941 942 943 608 678 711 711 780 679 617 619 652 648 717 608 608 130 130 868 769 800 130 612 66 66 608 742 711 617
717 608 66 973 974 975 721 608 710 711 679 679 718 715 780 712 717 608 608 608 66 238 132 132 721 678 616 66 66 608 710 718
717 608 66 1005 1006 1007 131 721 608 710 711 679 617 747 711 652 716 681 685 608 608 721 721 721 721 710 648 685 66 608 710 744
717 608 721 132 15 132 131 66 132 742 711 711 652 617 619 780 711 711 716 716 744 685 721 721 678 711 718 717 66 608 710 711
717 608 132 132 113 71 132 721 608 608 710 748 780 718 682 619 775 775 775 711 711 716 716 716 711 718 682 717 132 608 710 711
717 608 721 70 38 103 164 721 608 614 718 780 711 777 750 749 807 808 809 742 775 711 711 711 718 682 682 781 164 608 710 711
717 608 608 721 103 164 66 608 614 718 650 619 719 66 608 608 871 872 873 66 804 742 775 775 777 750 749 130 14 130 710 711
681 685 608 608 82 71 66 608 742 777 749 608 804 66 608 66 608 66 70 71 130 608 608 608 608 130 130 70 868 71 742 711
680 717 131 721 102 81 66 612 612 608 608 66 608 66 66 66 66 70 868 38 71 66 131 70 71 78 66 102 38 103 66 742
712 682 685 612 612 868 612 612 608 66 66 66 66 66 66 66 66 142 81 142 81 70 43 111 38 81 70 82 38 175 163 612
711 617 682 685 66 42 238 238 132 66 66 804 71 66 66 70 82 721 721 102 111 103 66 131 102 111 103 102 111 71 163 66
711 718 682 717 66 102 71 78 131 131 70 38 81 66 131 113 103 721 66 66 66 612 66 66 66 131 132 163 163 113 71 66
711 744 682 715 744 685 102 114 82 71 113 81 102 79 79 103 721 66 66 612 614 681 685 612 132 721 66 163 131 113 103 66
619 711 716 745 619 716 617 685 102 114 111 103 66 172 173 66 66 612 614 681 619 712 682 685 66 66 721 70 82 103 66 66
682 619 711 680 747 711 680 717 612 614 716 716 716 716 716 681 685 614 711 718 715 711 617 682 685 66 174 38 103 131 131 66
