FE5 - Fields
30 32
682 619 718 682 682 619 711 711 711 711 718 682 682 750 750 619 711 711 744 682 682 619 716 617 682 749 221 212 212 212 212 244
617 682 682 682 682 682 619 711 711 718 682 682 749 868 868 66 742 711 711 716 617 682 619 718 749 53 212 212 212 212 244 213
718 749 868 868 868 750 750 619 711 617 682 749 66 66 66 66 66 742 711 711 718 682 682 749 53 212 212 212 244 213 213 213
717 66 66 66 131 131 66 66 710 718 749 66 70 79 82 71 66 66 710 711 617 682 749 53 212 212 212 244 213 213 213 213
717 66 70 82 79 71 131 66 742 749 66 66 113 38 38 38 71 66 742 711 718 749 53 212 244 213 213 213 213 213 213 213
717 66 102 38 38 38 79 71 66 678 681 66 102 114 38 38 81 66 66 710 717 53 212 244 213 213 213 213 213 213 213 213
617 653 66 102 114 103 102 81 131 742 718 685 66 66 102 38 103 66 998 742 749 221 212 213 213 213 277 276 213 277 276 213
680 682 653 66 66 131 66 102 80 133 131 710 681 66 66 102 71 998 53 117 212 212 244 213 277 212 84 86 276 212 212 276
712 682 715 617 653 131 998 66 66 133 678 711 718 608 66 70 103 998 221 212 244 213 213 277 212 20 66 66 21 20 221 212
711 617 683 718 750 612 612 612 66 66 66 608 608 608 69 47 998 53 212 244 213 213 277 212 20 70 82 79 71 66 221 212
711 718 749 804 66 804 608 998 608 131 66 66 66 66 66 66 998 21 89 276 213 277 212 20 70 957 958 959 38 71 21 20
718 749 66 131 721 66 66 608 608 131 66 738 738 738 738 738 66 612 612 221 212 212 20 70 38 989 990 991 38 721 66 70
749 66 738 738 738 738 738 721 131 133 66 66 66 66 66 66 66 66 66 7 8 9 112 38 38 1021 1022 1023 38 38 82 38
66 66 69 721 721 70 82 79 80 69 608 608 608 678 617 682 685 66 66 221 212 220 66 102 103 102 38 38 38 721 721 38
133 133 721 79 82 38 38 103 608 608 608 608 678 711 718 749 53 117 212 212 212 212 52 66 66 66 721 38 721 38 38 38
133 133 113 721 38 38 103 66 608 608 678 716 711 718 749 53 212 212 244 213 245 212 212 212 119 119 66 102 111 114 103 102
998 721 102 38 38 103 131 608 678 716 711 711 718 749 53 212 212 244 213 213 213 213 245 212 212 213 52 66 66 66 66 66
653 133 131 721 81 66 678 716 711 711 711 718 749 53 212 212 244 213 213 213 213 213 213 245 212 212 220 119 66 66 66 66
617 653 131 66 102 131 710 711 711 711 718 717 53 212 244 213 213 213 213 213 213 213 213 213 213 245 212 212 52 119 53 52
718 715 617 653 66 69 742 647 647 711 744 717 221 212 213 213 213 213 213 213 213 213 213 213 213 213 245 212 212 212 212 212
715 716 718 682 653 69 131 66 66 742 711 717 221 212 276 213 212 212 276 213 213 213 213 213 213 213 213 213 245 212 212 212
716 711 617 682 749 66 69 66 66 133 710 717 21 212 212 212 212 89 212 276 213 213 213 213 213 213 213 213 213 245 212 212
711 711 680 682 653 66 69 69 66 608 742 749 998 21 212 212 212 52 21 212 212 276 213 213 213 213 213 213 213 213 213 245
711 711 712 682 717 66 66 69 608 608 66 66 66 998 21 89 89 20 721 21 213 212 213 213 213 213 213 213 213 213 213 213
711 711 711 617 682 653 66 131 69 66 66 721 721 582 756 766 799 729 734 721 21 212 276 213 213 213 213 213 213 213 213 213
711 711 711 718 682 682 653 131 69 69 66 729 756 756 724 837 901 901 724 734 721 21 212 276 213 213 213 213 213 213 213 213
711 711 718 682 715 617 717 131 202 269 207 721 721 582 724 837 997 901 724 724 734 721 21 212 213 213 213 213 213 213 213 213
711 718 682 715 711 712 682 653 678 716 744 653 207 998 829 766 829 788 788 788 766 721 53 212 213 213 213 213 213 213 213 213
711 617 682 619 718 619 744 682 653 742 711 711 716 716 716 617 653 53 52 721 721 53 212 244 213 213 213 213 213 213 213 213
711 711 716 716 617 715 711 617 682 653 742 711 711 711 711 718 717 221 212 117 117 212 244 213 213 213 213 213 213 213 213 213
