FE5 - Fields (Green)
30 32
650 650 750 750 749 604 666 629 998 66 721 66 721 721 721 738 66 66 721 772 721 772 721 636 629 66 66 66 66 66 66 66
650 749 596 597 596 666 605 614 653 721 66 721 103 786 787 721 721 786 787 66 721 738 738 628 597 197 196 596 597 197 66 66
749 596 666 666 666 635 629 742 749 66 70 38 82 818 819 35 66 818 819 721 66 721 66 66 628 597 596 629 628 602 602 602
596 666 666 666 629 614 718 653 130 70 38 721 721 721 80 721 721 102 721 82 721 738 66 66 66 628 629 66 66 604 666 634
666 666 666 629 614 718 749 860 858 861 38 721 66 786 787 738 738 738 47 46 721 71 66 738 738 66 721 836 996 604 605 66
666 666 605 614 617 749 721 892 890 893 103 66 721 818 819 721 721 69 721 721 35 47 721 66 66 66 66 900 900 604 629 66
666 666 605 710 648 721 721 924 922 925 66 721 614 716 716 716 716 617 653 721 35 721 66 66 66 66 66 238 596 605 66 66
628 666 605 710 648 653 66 786 787 721 721 614 617 619 711 711 711 718 682 653 998 721 35 35 35 66 196 596 666 629 66 66
653 628 605 742 719 721 721 818 819 721 614 711 718 747 775 775 775 712 717 596 597 998 721 721 738 738 228 604 605 66 66 66
650 653 604 597 998 721 786 787 721 614 711 718 749 868 868 868 868 742 712 628 605 998 721 66 738 738 596 634 629 66 66 66
717 66 7 9 868 721 818 819 614 711 718 749 197 238 238 238 238 66 710 685 600 614 934 721 66 66 600 66 66 66 66 66
749 66 604 605 998 721 721 614 711 718 717 721 66 102 82 79 71 66 742 749 600 998 738 738 66 66 600 66 66 66 66 66
66 66 628 666 597 614 716 716 718 682 717 596 597 66 102 38 81 738 738 998 600 998 66 66 66 66 600 66 66 66 66 35
738 738 66 604 605 710 711 718 682 750 749 628 629 70 82 38 103 66 66 998 628 570 570 6 570 570 629 66 66 738 738 738
70 80 66 604 605 742 647 719 749 738 738 738 738 113 38 103 738 738 738 66 66 66 721 66 66 66 66 133 133 66 35 133
103 66 197 7 9 66 721 69 15 15 66 35 66 113 103 69 66 133 738 738 66 738 721 721 76 133 112 71 15 78 78 78
772 66 66 628 605 721 772 772 721 114 71 78 70 38 82 82 721 78 78 133 66 786 787 721 102 71 133 102 38 38 114 81
130 868 66 596 629 66 66 66 721 721 721 807 808 809 721 38 721 721 721 721 721 818 819 133 70 81 35 35 110 110 133 69
130 868 596 629 130 130 868 130 130 130 721 871 872 873 66 113 103 113 38 175 133 66 70 82 38 103 66 69 133 133 738 66
130 596 605 66 738 738 238 132 721 721 66 69 130 130 106 110 106 110 102 82 71 70 38 38 81 69 69 133 738 738 738 66
130 604 605 721 721 197 70 721 71 66 130 70 175 69 66 133 35 35 35 721 721 38 38 114 103 66 738 738 738 66 66 53
52 564 564 66 132 721 721 721 102 82 82 38 71 133 35 35 35 66 721 721 113 38 103 66 66 738 738 738 66 53 117 212
212 212 220 66 772 772 772 197 66 110 110 102 114 80 69 66 66 66 66 66 102 38 868 66 738 738 738 66 53 212 212 212
212 212 220 130 772 772 868 197 66 66 130 772 772 69 66 69 66 66 66 66 112 103 238 738 738 66 66 53 212 212 212 244
245 212 220 130 130 868 772 772 868 197 868 772 772 66 66 772 772 772 772 772 66 66 738 738 66 66 53 212 212 244 244 213
213 212 212 52 130 130 66 772 772 772 69 197 66 53 52 772 772 772 772 772 53 52 66 66 66 53 212 212 244 244 213 213
213 245 212 212 52 130 130 66 69 66 130 66 53 212 212 117 117 117 117 117 212 220 66 66 53 212 212 212 244 213 213 213
213 213 245 245 212 117 117 117 117 117 117 117 212 212 244 213 213 213 213 212 212 212 117 117 212 212 244 213 213 213 213 213
213 213 213 213 245 212 212 212 212 212 212 212 244 244 213 213 213 213 213 213 212 212 212 212 212 212 213 213 213 213 213 213
213 213 213 213 213 245 212 212 212 212 212 212 244 213 213 213 213 213 213 213 213 213 212 212 212 244 213 213 213 213 213 213
