FE5 - Plains v2 Alt
30 32
802 802 802 802 802 802 802 802 802 802 929 928 962 962 802 802 802 802 802 802 802 802 802 802 802 802 802 802 802 802 802 802
802 802 802 802 802 802 802 802 802 933 416 416 384 384 928 802 802 802 802 802 802 802 802 802 802 802 802 962 962 962 962 802
802 802 802 802 802 802 802 802 802 933 68 68 68 68 68 928 962 802 802 802 802 802 802 802 802 802 929 68 68 68 896 802
802 802 802 802 802 982 824 983 802 802 897 68 68 68 68 68 68 928 962 962 962 802 802 802 962 929 68 740 740 68 901 802
802 802 802 802 802 952 854 953 929 928 962 994 897 68 68 68 68 68 68 68 68 928 802 933 648 207 207 68 68 896 802 802
802 802 802 802 802 984 886 985 247 246 648 928 802 994 994 994 897 740 740 68 68 68 928 929 334 337 231 896 994 802 802 962
802 802 802 802 802 897 648 247 212 280 648 68 901 802 802 802 802 897 68 68 68 68 68 608 68 239 68 928 802 802 933 68
802 962 962 802 802 802 897 215 283 214 648 68 901 802 802 802 802 933 68 68 740 740 740 68 68 994 68 68 901 802 962 994
933 68 68 928 962 802 933 648 648 648 994 648 901 802 802 802 802 802 994 994 994 994 994 994 994 802 897 648 928 933 648 901
802 994 897 68 68 901 962 994 994 994 802 994 802 802 802 802 802 802 802 802 962 802 802 802 802 802 933 68 68 901 994 962
802 802 802 994 994 933 68 928 802 802 802 802 802 802 802 802 802 802 802 933 648 901 962 962 802 802 802 897 68 928 933 68
802 802 802 802 962 802 897 68 901 802 802 802 802 802 802 802 802 802 802 802 994 933 648 68 928 802 802 933 68 68 901 994
802 802 802 929 68 901 802 994 802 802 802 802 802 802 802 802 802 802 802 802 802 802 994 897 648 901 802 929 68 68 901 802
802 802 933 68 608 928 962 962 802 802 962 962 962 802 802 802 802 802 802 802 802 802 802 802 994 802 933 68 994 896 962 929
802 802 802 897 68 68 68 68 928 929 256 68 68 928 962 802 802 802 802 802 802 802 802 802 802 802 802 994 962 929 68 68
802 802 802 802 994 994 897 68 68 68 648 198 199 207 68 901 802 802 802 802 802 802 802 802 802 802 962 929 68 68 740 740
802 802 802 802 802 802 802 994 994 897 334 337 337 231 68 901 802 802 802 802 802 802 802 802 962 929 68 68 68 207 68 68
802 802 802 802 802 802 802 802 802 933 68 230 333 68 896 802 802 802 802 802 802 802 802 929 68 68 68 68 198 333 648 68
802 802 802 802 802 802 802 802 802 802 897 68 369 896 962 962 962 962 962 962 802 802 929 68 68 68 68 648 337 337 199 198
802 802 802 802 802 802 802 802 802 933 596 569 38 569 569 569 569 569 569 597 901 929 68 68 648 198 367 199 366 337 337 335
802 802 802 802 802 802 802 802 802 933 632 68 68 68 68 68 68 256 68 632 929 68 68 68 334 231 239 230 337 335 231 68
802 802 802 802 802 802 802 802 802 933 632 68 207 198 367 199 68 68 68 632 933 68 68 68 68 68 68 68 648 68 648 68
802 802 802 802 802 802 802 802 802 933 632 68 230 231 238 239 68 68 68 2 68 68 68 648 68 68 648 68 68 68 68 68
962 962 962 962 962 929 928 802 802 933 632 68 68 648 68 68 68 68 68 632 68 68 68 68 68 247 313 313 38 313 313 313
569 569 569 569 569 569 597 928 962 929 632 648 68 416 648 68 68 68 68 314 313 313 313 313 313 989 957 958 1019 956 957 990
68 68 68 68 68 68 628 569 569 569 634 569 38 569 569 569 569 569 119 212 212 212 212 212 280 991 987 988 1020 988 33 991
68 68 68 68 68 68 68 68 68 68 68 68 68 68 68 68 68 68 215 212 212 212 212 212 280 991 1019 33 1019 1020 1020 991
68 68 740 740 68 68 68 68 198 367 199 268 269 68 68 68 68 68 247 212 244 213 245 212 280 1021 957 957 957 957 957 1022
68 68 68 68 68 68 68 334 335 337 337 337 337 199 68 68 68 247 212 244 213 213 213 245 280 1016 1017 1017 1017 1017 1017 1018
198 367 199 268 269 68 740 740 68 230 337 231 238 239 68 68 247 212 244 213 213 213 213 213 245 313 313 313 313 313 313 313
