FE5 - Castle v2 OG (Yellow)
32 24
589 589 589 589 589 589 589 338 1005 1006 1006 823 1005 1006 1006 1006 338 589 589 589 589 589 589 589
589 589 589 589 589 589 589 362 1005 1006 822 855 822 1005 1006 1006 362 589 589 589 589 589 589 589
338 395 398 398 338 589 589 362 1005 1006 1014 1015 1016 1006 1006 1006 362 589 589 338 395 398 398 338
362 973 974 974 362 589 589 362 1005 1006 1006 1006 1006 1006 1006 1006 362 589 589 362 973 974 974 362
362 1005 588 1005 362 589 589 338 1005 1006 1006 1006 1006 1006 1006 1006 338 589 589 362 1005 588 1005 362
362 1005 1006 1006 362 589 589 370 1005 1006 1006 1006 1006 1006 1006 1006 370 589 589 362 1005 1006 1006 362
338 395 400 398 338 589 589 402 395 339 425 458 458 459 339 395 402 589 589 338 395 400 398 338
370 683 460 683 370 589 589 402 683 371 425 458 458 459 371 683 402 589 589 370 683 460 683 370
402 715 460 715 402 395 398 402 715 403 425 458 458 459 403 715 402 395 398 402 715 460 715 402
434 747 460 747 434 641 641 434 747 435 425 458 458 459 435 747 434 641 641 434 747 460 747 434
974 974 974 974 974 974 974 974 974 974 974 974 974 974 974 974 974 974 974 974 974 974 974 974
398 329 1005 1006 323 398 398 398 398 329 1005 1006 1006 1006 323 398 398 398 398 329 1005 1006 323 398
517 362 1005 1006 362 515 516 516 517 362 1005 1006 1006 1006 362 515 516 516 517 362 1005 1006 362 515
549 362 1005 1006 362 547 548 548 549 362 1005 1006 1006 1006 362 547 548 548 549 362 1005 1006 362 547
581 339 1005 1006 339 579 580 580 581 339 395 398 398 398 339 579 580 580 581 339 1005 1006 339 579
974 371 425 459 371 973 974 974 974 371 515 516 516 517 371 973 974 974 974 371 425 459 371 973
1006 403 425 459 403 1005 1006 1006 1006 403 547 548 548 549 403 1005 1006 1006 1006 403 425 459 403 1005
1006 435 425 459 435 1005 320 322 1005 435 579 580 580 581 435 1005 320 322 1005 435 425 459 435 1005
1006 974 974 974 974 1006 352 354 1005 974 974 974 974 974 974 1006 352 354 1005 974 974 974 974 1006
1006 1006 1006 1006 323 398 389 390 398 399 1005 1006 1006 1006 396 398 389 390 398 329 1005 1006 1006 1006
1006 1006 1006 1006 362 515 516 516 516 517 425 458 458 459 515 516 516 516 517 362 1005 1006 1006 1006
398 398 398 398 339 547 548 548 362 581 425 458 458 459 579 362 548 548 549 339 395 398 398 398
516 516 516 517 371 547 548 548 362 973 974 974 974 974 974 362 548 548 549 371 515 516 516 516
548 548 548 549 403 547 548 548 362 1005 1006 1006 1006 1006 1006 362 548 548 549 403 547 548 548 548
548 548 548 549 403 579 580 580 339 399 1005 396 399 1005 396 339 580 580 581 403 547 548 548 548
580 580 580 581 403 973 974 974 371 517 1005 515 517 1005 515 371 973 974 974 403 547 548 548 548
974 974 974 974 435 1005 1006 1006 403 549 460 547 549 460 547 403 1005 1006 1006 435 579 580 580 580
1006 1006 1006 1006 974 1006 1006 1006 435 581 460 579 581 460 579 435 1005 1006 1006 974 974 974 974 974
1006 1006 1006 1006 1006 1006 1006 1006 974 974 460 973 974 460 973 974 1006 1006 1006 1006 1006 1006 1006 1006
1006 1006 1006 1006 1006 1006 1006 1006 1006 1006 1006 1006 1006 1006 1006 1006 1006 1006 1006 1006 1006 1006 1006 1006
1006 1006 1006 1006 1006 1006 1006 1006 1006 1006 1006 1006 1006 1006 1006 1006 1006 1006 1006 1006 1006 1006 1006 1006
1006 1006 1006 1006 1006 1006 1006 1006 1006 1006 1006 1006 1006 1006 1006 1006 1006 1006 1006 1006 1006 1006 1006 1006
