FE5 - Fields
22 32
163 163 163 163 163 163 163 163 738 738 163 163 163 600 721 163 721 600 165 165 163 102 38 38 38 71 130 130 130 70 38 38
163 99 163 163 721 721 721 163 738 738 738 738 738 600 721 163 721 600 738 738 738 37 113 38 38 721 82 79 79 38 38 38
163 70 860 858 861 163 786 787 71 163 99 99 163 600 721 70 721 600 163 163 721 70 38 38 38 38 38 38 103 102 38 103
163 102 892 890 893 721 818 819 721 82 79 71 163 600 721 804 721 600 70 82 38 38 38 721 721 721 103 110 163 174 38 71
71 70 924 922 925 163 163 113 38 38 38 721 721 600 721 71 163 600 38 38 114 786 787 110 102 38 71 738 738 165 721 103
38 103 163 15 70 82 79 38 38 38 38 38 38 2 38 996 163 600 102 103 37 818 819 721 868 721 103 738 738 738 102 71
81 163 163 113 81 110 102 38 38 38 38 721 721 600 721 169 721 600 130 163 116 117 118 721 721 721 721 165 165 37 130 102
143 163 70 38 103 78 75 110 102 38 807 808 809 600 721 109 721 600 130 163 91 212 212 117 117 117 117 117 58 163 130 130
38 71 102 169 70 38 137 163 163 102 871 872 873 600 721 163 721 600 163 163 123 244 213 213 213 213 213 245 212 218 130 130
102 721 721 82 38 38 143 738 738 738 168 169 163 604 570 570 570 699 4 4 212 213 213 213 213 213 213 213 212 218 786 787
163 163 721 721 38 38 721 738 738 738 136 73 141 600 721 163 721 604 68 68 212 213 213 213 213 213 213 213 212 218 818 819
738 738 102 38 38 38 38 71 99 174 38 38 81 600 721 163 721 600 163 163 21 276 213 213 213 213 213 277 212 218 130 721
163 99 163 721 103 721 102 103 99 99 721 114 103 604 570 570 570 629 70 71 219 84 85 85 85 85 85 85 85 165 738 738
163 163 163 113 71 163 163 163 163 163 721 163 163 600 804 163 163 165 142 143 37 738 738 738 804 163 721 163 37 163 130 738
570 570 570 570 34 570 570 570 570 570 570 570 570 629 721 163 165 165 142 38 721 37 738 738 163 165 163 163 37 738 738 130
738 738 163 163 163 163 163 163 163 163 738 738 738 721 163 165 165 163 142 38 38 77 37 37 738 738 738 37 738 738 130 130
163 163 163 70 807 808 809 79 868 738 738 163 163 163 163 738 738 721 142 721 38 175 163 868 74 134 71 165 163 163 738 738
163 78 70 38 871 872 873 38 103 163 163 163 163 70 71 165 165 70 38 38 38 73 141 238 106 166 38 82 82 71 163 130
82 38 38 38 38 38 114 721 738 738 738 738 70 804 102 71 70 38 38 38 38 721 38 71 163 70 38 38 38 38 143 721
38 103 102 38 38 38 79 79 79 71 163 163 172 173 130 142 900 38 804 38 38 103 102 114 82 38 38 38 38 114 103 721
103 163 163 738 738 738 110 110 110 102 71 163 70 71 70 38 38 38 38 38 38 130 738 738 102 114 38 38 143 130 130 721
738 738 738 163 163 163 163 721 163 721 102 82 38 38 38 38 38 38 38 38 103 130 130 130 721 130 102 38 103 130 130 130
