FE5 - Fields (Dark)
30 32
786 787 721 721 721 721 721 721 721 738 738 3 70 38 38 38 38 38 38 38 38 38 103 721 721 721 721 786 787 880 881 882
818 819 759 731 731 965 721 721 738 738 3 70 38 38 38 38 38 111 111 103 102 81 66 15 66 721 721 818 819 912 913 914
721 721 795 901 837 796 66 66 66 70 82 38 38 103 102 114 103 721 721 721 66 113 82 38 71 738 738 721 721 944 945 946
721 721 791 763 763 792 112 71 70 38 38 114 103 738 738 721 721 646 744 685 721 102 114 38 38 71 3 15 738 721 786 787
880 881 882 721 721 66 66 113 38 38 103 721 721 786 787 721 721 711 711 617 685 721 721 47 721 102 82 38 71 3 818 819
912 913 914 66 66 738 165 102 38 81 880 881 882 818 819 721 646 711 711 718 717 786 787 721 721 66 142 38 38 80 721 721
944 945 946 66 66 165 165 70 114 103 912 913 914 721 646 617 619 711 718 682 717 818 819 721 721 721 142 38 103 738 738 721
721 646 716 617 685 165 100 47 66 721 944 945 946 646 711 712 682 619 712 682 682 685 721 721 738 738 102 81 37 721 721 721
646 711 711 718 715 716 716 716 716 649 716 716 617 619 711 711 712 715 711 617 682 717 608 721 721 66 70 38 71 66 786 787
711 718 775 775 775 711 711 711 711 718 619 711 718 682 619 711 711 716 711 648 682 717 786 787 721 70 38 38 38 71 818 819
718 749 938 939 940 742 711 711 711 718 750 750 750 750 715 711 711 711 711 718 682 749 818 819 3 113 721 38 38 38 71 66
717 998 970 971 972 998 742 775 718 749 70 71 721 721 742 647 711 711 718 682 749 721 721 721 66 142 38 721 38 38 721 80
717 998 1002 1003 1004 165 37 165 165 112 114 143 3 66 721 742 775 718 750 749 786 787 721 37 70 38 721 38 721 38 81 66
717 998 868 66 868 998 646 685 37 165 70 103 721 721 738 738 721 721 721 721 818 819 37 721 142 38 721 38 38 721 38 80
712 653 998 998 998 646 718 717 37 70 38 721 738 738 721 165 165 721 738 738 738 738 738 70 38 38 38 38 721 38 38 721
647 712 715 716 716 718 682 749 66 113 721 721 100 721 100 738 738 70 71 721 70 721 721 38 38 721 38 721 721 38 786 787
742 647 716 711 718 750 749 66 721 721 786 787 721 721 608 721 721 114 721 38 38 721 38 721 38 38 38 721 38 721 818 819
721 742 775 718 749 738 738 70 38 38 818 819 646 716 716 716 617 650 653 102 721 721 38 721 38 38 38 38 721 38 721 721
721 721 721 100 15 721 82 38 721 721 721 646 711 711 711 711 718 650 650 653 102 721 868 38 721 38 721 38 38 81 37 721
880 881 882 721 102 114 38 721 38 721 646 711 711 625 458 458 458 626 650 650 653 721 38 38 38 38 38 38 38 38 721 66
912 913 914 721 721 66 721 38 81 646 711 711 625 523 423 33 423 522 626 650 650 653 721 114 38 38 38 38 38 38 721 71
944 945 946 786 787 721 3 113 721 710 711 711 657 423 455 582 487 455 657 650 650 717 721 721 721 38 38 38 38 38 38 143
721 608 721 818 819 738 738 102 71 710 711 711 522 626 487 455 455 625 523 650 650 717 721 721 37 113 38 868 38 38 721 721
617 653 721 608 721 721 66 70 143 742 647 711 711 657 487 455 455 657 650 650 650 749 721 738 738 113 38 38 721 38 786 787
680 682 653 721 721 721 721 102 143 3 742 647 711 522 626 487 625 523 650 650 749 721 721 66 70 721 38 721 38 38 818 819
712 682 682 653 721 609 610 721 173 721 868 742 711 711 657 421 657 750 750 749 721 721 66 721 721 38 38 38 721 721 786 787
711 617 715 716 617 653 721 786 787 721 673 741 772 721 554 421 554 721 721 721 738 738 721 3 868 38 38 721 721 721 818 819
711 711 649 619 680 717 721 818 819 880 881 882 721 3 3 3 738 721 37 37 721 721 738 738 42 113 103 721 66 721 66 721
711 711 712 715 718 717 721 608 721 912 913 914 721 37 37 37 738 738 721 3 721 71 70 82 721 81 721 721 721 721 721 738
711 711 711 649 715 716 617 653 721 944 945 946 66 721 66 721 66 721 66 721 38 81 721 103 102 721 721 738 721 721 3 721
