FE5 - Fields
22 32
682 750 750 750 750 619 712 682 682 682 619 718 682 682 750 619 712 682 682 682 750 749 632 710 711 711 718 682 619 712 682 682
717 66 868 66 66 710 711 617 682 750 750 750 750 749 162 868 742 617 682 749 596 570 629 742 711 718 682 750 750 619 777 682
717 130 238 612 721 710 711 648 749 164 721 721 66 612 162 238 614 718 804 596 605 807 808 809 710 617 654 721 162 742 711 777
682 653 612 721 130 66 742 719 66 164 130 721 612 162 66 614 718 231 66 604 605 871 872 873 742 687 781 804 71 721 742 775
682 749 66 66 66 66 164 164 164 164 130 66 612 162 614 718 900 162 162 604 605 102 103 67 721 719 162 142 143 67 162 614
749 130 66 66 164 596 597 66 721 130 721 66 612 66 742 719 162 70 38 7 9 70 71 738 738 612 67 142 143 162 646 711
653 130 66 66 164 628 629 845 846 846 847 66 66 162 612 70 82 103 596 667 629 102 111 71 70 79 79 38 38 721 721 710
717 66 130 738 738 738 130 877 878 878 879 66 66 612 174 103 110 596 667 629 67 721 162 142 38 38 38 721 103 721 162 742
749 66 130 738 738 66 164 909 910 910 911 66 612 612 174 71 596 667 629 162 174 71 70 721 38 721 38 143 162 721 721 162
66 66 66 130 868 70 71 164 102 81 612 66 612 100 70 38 7 9 78 78 70 38 38 38 38 721 38 103 67 738 738 67
112 79 71 66 238 142 38 71 164 102 38 71 14 70 103 162 604 605 102 38 38 38 38 38 721 721 38 721 71 67 721 67
130 46 102 79 79 38 38 38 79 80 46 102 114 114 71 162 604 605 100 102 111 38 38 38 38 143 102 111 804 162 721 162
653 66 106 102 38 38 38 38 103 66 66 164 66 721 81 721 604 605 66 162 721 102 103 102 111 103 67 99 738 738 738 721
744 653 66 174 38 38 721 103 66 130 66 612 721 76 721 100 604 605 162 162 99 162 162 67 67 67 67 99 67 67 67 67
711 744 653 130 102 111 721 130 66 66 130 614 612 108 721 612 604 667 602 571 570 34 571 570 570 34 570 571 570 34 570 571
742 711 617 653 66 721 612 130 614 718 612 719 130 721 614 653 604 667 605 99 70 71 738 738 738 99 738 738 67 67 738 738
66 742 712 654 868 614 718 685 742 749 721 66 66 614 718 749 604 634 629 99 142 38 71 78 78 78 78 78 70 71 162 67
66 66 742 749 238 742 749 164 66 721 66 721 66 710 717 596 629 100 100 70 38 38 38 38 38 38 103 102 38 103 67 67
738 738 66 721 721 612 738 738 738 130 130 66 66 710 717 632 70 721 79 38 38 38 868 38 103 110 107 174 103 67 67 67
130 130 721 721 738 738 738 738 738 738 130 66 66 742 749 664 142 38 721 102 103 110 102 38 71 67 67 67 162 67 67 67
738 738 66 786 787 66 721 66 868 66 738 738 738 162 162 632 168 167 173 738 738 721 880 881 882 721 67 738 738 162 738 738
66 66 721 818 819 721 66 738 738 738 738 66 66 162 162 696 106 107 162 67 721 721 912 913 914 738 738 738 67 721 67 67
