FE5 - Fields (Dark)
23 32
103 107 98 66 66 66 66 66 66 66 66 66 69 66 66 66 66 66 102 38 38 38 38 38 103 102 103 66 66 66 66 66
71 75 625 458 458 458 458 458 458 689 458 458 458 458 458 458 458 458 689 461 461 461 461 461 461 461 461 461 461 626 98 98
38 175 657 423 455 455 455 455 455 554 423 455 455 455 455 455 455 33 657 495 493 493 493 493 493 493 493 493 493 657 66 66
38 71 657 487 455 455 455 455 455 455 455 455 455 455 455 455 455 455 657 71 102 38 38 38 71 162 66 78 70 490 461 461
38 38 657 487 455 455 625 458 458 626 487 455 455 455 625 461 433 455 554 38 71 729 724 724 724 734 70 721 38 497 493 493
38 38 657 487 455 455 554 423 33 657 487 455 455 455 657 495 497 421 497 38 38 724 724 724 724 724 734 103 102 38 103 98
625 458 523 487 455 455 455 455 455 657 487 455 455 455 522 626 69 421 38 38 38 730 724 724 724 724 766 721 98 625 461 461
657 487 455 455 455 455 455 455 455 657 487 455 455 455 455 657 66 721 721 721 102 103 110 110 110 66 66 98 98 657 495 493
657 487 455 455 455 455 455 455 455 522 458 459 487 457 458 458 458 458 458 458 458 458 689 458 458 458 458 458 458 458 458 626
657 487 455 455 455 455 455 455 455 455 33 423 455 455 455 455 455 455 455 455 455 33 657 486 519 519 519 519 519 519 519 657
657 487 455 658 487 658 487 455 455 455 455 455 455 455 455 455 455 455 455 455 455 455 657 518 454 454 454 454 454 454 454 657
657 487 455 657 487 657 487 455 620 621 621 621 621 621 621 622 487 455 455 455 455 455 657 518 454 454 454 454 454 454 454 657
657 487 455 657 33 657 487 455 623 624 458 582 549 582 458 623 622 487 455 455 455 455 657 518 454 454 454 454 454 454 454 657
657 487 455 657 487 657 487 455 623 624 487 582 581 582 487 623 624 487 455 582 582 487 464 430 430 430 430 430 430 689 461 491
657 487 455 554 487 554 487 455 623 624 487 421 421 421 487 623 624 487 455 455 455 455 455 455 455 455 455 455 455 657 495 497
657 487 455 455 455 455 455 455 623 624 487 455 455 455 455 623 624 487 455 455 455 455 455 455 455 455 455 455 455 657 161 164
657 487 455 455 455 455 455 455 623 624 487 455 455 455 455 623 624 487 455 455 455 455 455 455 455 455 455 455 455 657 161 66
657 487 455 582 455 582 455 455 522 523 487 455 455 455 455 655 463 461 461 461 461 433 455 455 462 461 461 461 461 491 161 69
657 487 455 455 455 455 455 455 455 455 455 455 455 455 455 657 495 493 493 493 493 497 421 421 497 495 493 493 493 497 78 70
657 487 455 455 455 455 455 455 455 455 455 455 455 455 455 657 161 69 69 69 69 69 421 421 98 66 66 66 74 72 38 38
490 461 461 461 461 461 461 461 461 461 461 461 461 461 461 491 161 70 900 66 66 98 102 38 71 78 721 721 72 721 38 38
497 495 493 493 493 493 493 493 493 493 493 493 493 493 493 497 70 38 38 721 74 78 70 38 38 721 38 38 721 102 103 102
38 38 38 38 71 78 66 66 66 66 66 66 66 66 66 70 38 38 38 71 70 38 38 38 38 38 38 103 66 66 140 70
