FE5 - Fields
30 32
196 897 995 994 995 994 995 994 995 994 995 994 995 994 995 994 995 994 995 994 995 994 995 994 995 994 929 786 787 880 881 882
897 929 70 71 37 37 66 131 721 721 721 66 721 721 721 721 721 721 66 897 995 995 995 995 929 786 787 818 819 912 913 914
995 70 860 858 861 71 78 78 70 71 721 721 721 66 721 37 721 721 721 995 994 929 37 721 721 818 819 721 721 944 945 946
995 102 892 890 893 38 114 38 103 173 897 994 994 994 994 995 994 994 421 995 66 658 721 66 721 66 738 738 66 721 786 787
929 37 924 922 925 103 66 102 109 131 995 994 994 994 994 994 994 994 421 929 66 490 461 461 626 66 66 66 738 738 818 819
928 896 102 38 103 164 66 66 897 994 929 131 37 66 101 101 66 66 66 66 66 497 495 496 623 622 66 37 37 66 786 787
37 928 995 421 994 995 994 994 929 66 66 37 625 458 689 458 458 458 626 66 66 66 66 721 623 624 131 70 71 66 818 819
37 66 66 66 164 164 66 66 66 66 37 625 523 423 554 423 455 455 657 66 421 66 66 721 623 448 37 102 169 738 738 721
37 66 70 82 71 164 101 101 101 101 625 523 423 455 455 455 455 455 522 458 484 458 689 689 656 497 164 174 137 66 66 66
37 66 102 721 38 71 78 101 101 625 523 423 582 487 455 455 582 487 455 455 455 455 657 657 448 66 164 70 38 175 66 66
37 37 101 102 721 38 103 101 66 657 423 455 455 455 658 487 455 455 455 455 625 458 555 623 622 66 164 142 38 71 66 66
721 37 721 37 37 113 71 101 66 522 689 459 455 457 555 689 458 458 484 458 656 33 33 522 623 622 164 102 38 103 66 66
786 787 964 66 964 102 81 37 37 448 657 423 582 582 423 657 423 455 455 455 657 423 455 455 623 624 164 174 38 71 66 66
818 819 900 66 836 721 102 175 101 497 490 626 423 582 582 657 487 455 455 455 657 487 455 455 522 655 626 37 102 38 71 66
131 721 238 66 238 140 70 71 101 37 497 490 626 423 455 522 626 487 625 458 523 487 455 455 455 623 624 37 108 114 38 71
131 164 738 738 900 113 38 81 164 721 721 497 657 487 455 455 522 689 523 423 455 455 455 455 455 623 448 164 174 71 102 103
52 197 66 66 238 102 38 38 71 140 141 164 448 626 487 455 455 554 423 455 455 455 455 455 455 657 497 164 70 38 71 66
212 218 131 800 706 706 721 38 38 114 103 66 497 657 487 455 455 455 455 455 455 455 455 455 625 491 37 868 38 38 81 131
20 15 131 721 141 140 113 103 114 721 77 101 66 657 487 455 455 455 455 455 455 455 455 625 491 497 37 37 113 38 143 66
52 102 82 82 103 102 38 109 74 70 71 66 101 657 487 582 487 455 455 455 455 455 620 624 497 66 66 66 168 169 173 66
245 52 102 38 71 37 721 135 75 110 102 71 37 657 487 455 455 455 625 461 448 487 448 448 66 66 131 131 136 137 75 131
213 245 52 38 81 37 37 721 107 74 70 103 37 448 626 487 582 487 657 495 497 421 497 529 448 131 66 70 38 38 175 66
213 277 20 102 38 71 66 66 66 108 38 175 66 497 490 461 461 461 448 131 131 421 66 561 497 66 66 102 38 103 107 131
213 245 52 119 102 111 82 71 66 66 102 71 131 131 493 493 493 493 497 66 70 81 66 66 66 66 721 66 102 71 164 66
213 213 245 245 52 119 102 111 71 721 174 38 82 71 66 37 37 37 66 70 38 38 71 66 131 131 131 721 70 103 37 164
213 213 213 213 245 212 52 119 38 77 66 102 721 103 37 66 70 79 71 113 38 38 38 79 79 71 78 70 103 37 66 786
213 213 213 213 213 245 212 20 38 71 75 66 102 71 721 66 113 38 114 38 38 114 103 102 103 102 103 102 175 66 66 818
213 213 213 213 213 213 245 52 102 38 71 15 70 114 71 70 38 103 66 102 103 738 738 738 66 101 101 101 101 880 881 882
213 213 213 213 213 213 213 245 52 102 114 111 38 71 102 114 103 66 66 66 738 738 66 66 66 66 66 66 721 912 913 914
213 213 213 213 213 213 213 213 245 52 119 119 102 143 66 738 738 66 66 66 66 738 738 66 66 66 721 786 787 944 945 946
