FE5 - Fields (Lava)
32 32
35 66 66 66 66 66 66 66 66 66 66 66 221 212 244 213 213 213 213 213 212 212 212 20 21 88 20 120 21 88 20 21
35 35 35 35 3 3 3 33 161 33 161 66 221 212 213 213 213 213 213 213 213 212 212 52 69 66 69 66 66 66 66 66
66 66 66 35 66 66 66 66 66 66 66 66 221 244 213 213 213 277 276 213 213 213 212 212 52 69 772 772 66 33 66 66
66 66 66 66 35 66 66 66 66 66 66 53 212 213 213 213 277 212 212 276 213 213 213 212 212 52 119 69 66 66 33 66
66 772 772 35 35 66 66 66 69 69 53 212 244 213 213 277 212 212 212 212 212 276 213 212 212 212 212 218 69 66 66 66
66 66 35 35 66 66 119 165 66 53 212 244 213 213 213 212 212 88 20 120 21 212 276 213 213 212 212 218 69 69 772 772
66 35 35 66 66 53 212 117 117 212 212 213 213 213 277 212 220 66 35 35 66 21 212 212 212 212 20 66 66 66 69 69
66 35 66 66 66 221 212 212 212 212 212 213 213 277 212 212 20 69 66 35 35 99 120 21 88 212 218 99 66 772 772 772
35 35 35 66 66 21 20 120 21 88 212 276 213 212 212 20 772 772 99 99 35 35 66 66 66 7 9 69 165 99 99 165
66 66 35 35 66 66 69 66 69 165 21 212 212 212 20 66 35 35 35 35 66 35 35 165 53 212 212 52 421 117 421 53
772 772 66 35 66 772 772 772 66 66 66 221 220 66 35 35 35 772 772 165 165 165 35 35 221 212 212 212 288 220 289 212
66 772 772 66 35 66 66 66 66 66 66 7 9 35 35 99 99 165 772 772 421 421 421 35 221 244 245 212 421 120 421 212
66 66 66 66 35 35 99 772 772 99 99 221 220 66 99 53 52 165 165 165 288 224 289 117 244 213 213 212 288 224 289 212
66 66 66 421 421 35 35 99 53 52 53 212 212 117 117 212 212 52 165 165 225 224 226 212 213 213 213 245 220 224 226 353
53 52 352 225 226 119 119 53 212 212 212 244 213 213 245 212 212 212 52 53 225 224 226 212 276 213 213 213 212 218 226 385
212 212 384 225 226 212 212 212 212 212 244 213 213 213 213 245 212 212 212 212 225 224 226 353 212 276 213 277 120 224 119 212
212 212 212 225 226 353 212 212 212 244 213 213 213 213 213 213 245 212 212 352 225 224 226 385 212 212 277 352 225 219 212 244
213 212 212 225 226 212 212 212 244 213 213 213 213 213 213 213 213 245 212 384 225 224 226 212 212 212 212 384 119 219 212 276
213 213 20 421 421 85 86 212 276 213 213 213 213 213 213 213 213 277 212 212 320 224 321 212 212 212 212 212 220 219 88 212
213 220 66 66 66 66 66 21 212 213 213 213 213 213 213 213 213 212 625 459 421 421 421 457 626 212 212 658 320 224 321 457
212 220 66 66 421 66 66 53 212 213 213 213 213 213 213 213 277 212 657 423 422 422 422 422 657 212 212 657 421 421 421 423
212 212 52 421 226 119 53 212 212 276 213 213 213 213 213 213 212 212 657 487 455 455 455 455 657 221 220 657 423 422 422 455
212 212 212 225 117 212 212 212 212 212 212 276 213 213 213 277 212 212 657 487 455 455 455 455 657 221 220 657 487 455 455 455
212 212 212 225 88 212 212 212 212 212 212 212 276 213 277 212 212 220 657 487 455 455 455 455 448 221 220 448 487 455 455 455
212 212 212 320 321 21 88 20 120 21 88 212 212 212 212 212 212 220 448 487 455 455 455 455 497 458 458 497 487 455 455 455
212 212 20 421 421 66 66 738 738 165 165 21 212 212 212 212 212 212 497 487 455 455 455 455 422 422 422 422 455 455 455 455
212 220 66 66 66 66 66 66 66 66 66 192 193 193 219 212 212 218 194 487 455 455 455 455 455 455 455 455 455 455 455 455
212 220 66 66 66 738 738 66 66 66 66 256 221 212 218 120 120 257 258 487 455 455 455 455 455 455 455 455 455 455 455 455
212 220 738 738 66 66 66 66 66 738 738 66 221 212 376 378 212 375 658 487 455 455 455 455 455 455 455 455 455 455 455 455
245 212 52 66 66 33 66 66 66 53 117 117 212 212 212 212 212 212 657 487 455 455 455 455 455 455 455 455 455 455 455 455
213 245 212 117 117 117 117 117 117 212 212 212 244 213 213 245 212 212 657 487 455 455 455 455 455 455 455 455 455 455 455 455
213 213 245 212 212 212 212 212 212 244 213 213 213 213 213 213 213 245 554 487 455 455 455 455 455 455 455 455 455 455 455 455
