FE5 - Castle v2 OG (Dark)
30 32
323 398 398 324 398 398 398 398 324 398 398 398 329 33 323 398 398 398 398 398 329 33 35 35 402 402 33 338 338 33 338 338
362 973 974 362 973 974 974 974 362 973 974 974 355 398 393 717 782 718 782 718 362 33 35 35 434 434 33 370 370 33 338 338
362 1005 1006 362 1005 1006 1006 1006 362 1005 1006 1006 362 781 718 814 750 814 750 814 387 398 329 33 35 35 35 402 402 33 370 370
362 1005 1006 427 427 427 465 427 427 1005 323 398 393 749 814 750 814 750 814 750 782 718 362 33 35 35 35 434 434 33 402 402
362 1005 1006 1006 1006 1006 1006 1006 1006 1006 362 781 718 814 750 814 750 814 750 814 750 814 387 324 398 398 398 329 33 35 402 402
355 399 428 330 1005 1006 1006 1006 323 398 393 749 814 750 814 750 814 750 814 750 814 750 782 394 781 718 782 387 398 398 329 434
362 781 718 387 398 398 398 398 393 781 718 814 750 814 750 814 750 750 822 813 750 814 750 822 749 814 750 782 718 782 362 33
362 749 814 750 814 750 814 750 814 750 814 750 814 750 814 750 822 749 720 719 814 750 814 822 813 750 814 750 814 750 362 33
362 813 750 814 750 814 750 814 750 814 750 814 750 814 750 814 720 814 750 814 750 814 750 822 749 814 750 814 750 814 362 33
362 749 814 750 814 750 814 750 814 323 398 398 398 398 329 749 814 750 814 750 814 750 814 822 813 750 814 323 398 398 393 33
362 813 750 814 750 814 750 814 750 362 640 641 641 642 387 398 329 813 750 814 750 814 750 330 749 814 750 362 640 641 642 33
355 329 813 750 814 750 814 750 814 362 1 2 2 2 640 642 362 749 814 750 814 750 323 388 398 398 398 393 1 2 2 35
355 388 329 813 750 814 750 814 750 362 33 35 506 35 2 2 387 398 338 813 750 338 339 640 641 641 641 642 65 35 35 35
362 717 394 749 814 323 398 400 398 388 329 33 35 35 35 74 640 642 370 425 459 370 467 97 173 173 173 160 97 506 64 136
362 813 750 814 750 362 973 974 974 974 387 329 33 375 375 35 96 506 434 425 459 434 97 35 375 375 35 35 72 128 32 32
362 749 814 750 814 362 1005 1006 1006 1006 974 387 329 33 375 375 64 97 35 535 537 35 68 141 141 69 74 136 32 32 32 32
339 329 749 814 750 387 329 1005 1006 556 1005 974 387 329 74 136 32 506 35 535 537 35 506 96 168 75 35 96 97 96 32 32
467 362 813 750 814 750 387 398 329 973 556 1005 974 362 33 96 97 96 65 535 537 35 35 506 506 35 35 35 35 35 96 168
224 362 749 814 750 814 750 814 387 329 973 556 1006 387 398 329 33 64 97 535 536 504 504 504 504 504 533 375 375 35 35 35
35 362 813 750 814 750 814 750 814 363 322 973 556 973 556 363 321 321 321 322 568 568 568 568 568 536 536 504 504 504 504 504
35 363 322 813 750 814 750 814 750 352 358 399 400 396 821 823 824 385 385 390 398 398 398 329 506 564 568 568 568 568 568 568
193 352 354 749 814 750 814 750 814 352 354 717 782 718 853 855 856 718 782 718 782 718 782 387 329 193 74 136 65 35 35 35
323 389 390 398 398 399 749 814 396 389 390 399 822 822 822 1011 822 822 822 822 749 814 750 814 355 398 398 398 398 398 398 338
362 717 782 718 782 718 814 750 782 718 782 718 784 720 822 749 822 720 784 720 323 339 400 339 339 640 641 641 641 641 642 370
362 813 750 814 750 814 822 822 749 814 330 813 750 750 720 783 720 814 750 814 362 467 492 467 467 503 504 533 506 2 2 434
339 329 813 750 814 822 784 720 822 749 362 749 814 750 814 750 814 750 814 750 362 1 492 1 503 536 595 537 556 506 208 35
467 362 749 814 750 784 822 822 720 783 387 324 399 813 396 398 398 324 398 398 361 33 35 64 535 536 536 537 57 56 240 506
224 387 398 329 813 750 784 720 814 750 814 362 781 750 782 718 782 362 640 642 362 33 64 32 535 536 536 537 21 26 35 35
206 640 642 362 749 814 750 814 750 814 750 362 749 814 750 814 750 362 1 2 387 398 398 398 398 398 398 398 398 398 398 338
35 300 301 387 398 398 398 398 398 398 398 388 398 398 398 398 398 393 33 35 640 641 641 641 641 641 641 641 641 641 642 370
