FE5 - Castle v2 OG (Purple)
30 32
175 175 175 175 175 362 362 403 1005 435 1005 435 339 339 395 398 398 339 339 435 1005 435 1005 435 1005 435 1005 435 1005 435 1005 362
175 175 175 175 175 362 339 435 1005 1006 1006 1006 371 371 515 516 517 371 371 973 1006 1006 1006 1006 1006 1006 1006 1006 1006 1006 1006 362
175 175 175 175 175 362 371 973 1006 1006 1006 1006 435 435 547 523 549 435 435 1005 1006 1006 1006 1006 1006 1006 1006 1006 1006 1006 1006 362
305 305 305 305 305 338 395 329 339 1005 1006 1006 1006 822 822 979 822 822 973 1006 1006 1006 1006 339 323 398 329 1005 1006 1006 1006 339
338 35 35 35 35 370 675 362 371 1005 1006 1006 1006 976 822 1011 822 976 975 1006 1006 1006 1006 371 338 675 339 425 458 458 459 371
370 323 398 398 398 402 707 338 395 329 339 1005 1006 1006 976 1006 976 1006 1006 1006 1006 339 323 398 370 707 402 425 458 458 459 403
323 393 973 1006 1006 402 707 370 675 362 371 1005 1006 1006 1006 1006 1006 1006 1006 1006 1006 371 338 675 402 707 402 425 458 458 459 403
362 973 1006 1006 1006 402 707 402 707 338 395 329 339 1005 1006 1006 1006 1006 1006 339 323 398 370 707 402 707 402 425 458 458 459 362
362 1005 556 1005 556 402 707 402 707 370 675 362 371 1005 1006 1006 1006 1006 1006 371 362 675 402 707 402 739 434 973 974 974 974 362
362 1005 1006 1006 1006 402 707 402 707 402 707 338 395 398 398 398 398 398 398 398 338 707 402 707 402 973 974 1006 323 398 398 338
355 398 398 465 398 402 707 402 707 402 707 370 519 516 516 516 516 516 516 517 370 707 402 739 434 1005 323 398 339 519 517 402
362 973 822 973 822 402 707 402 707 402 707 402 551 548 548 548 548 548 548 549 402 707 402 973 974 1006 362 675 371 551 549 402
362 1005 976 1006 976 402 707 402 707 402 707 402 551 548 548 548 548 548 548 549 402 739 434 1005 323 398 339 707 403 551 549 402
362 1005 822 1005 822 402 707 402 707 402 707 362 551 548 548 548 548 548 548 549 402 973 974 1006 362 675 403 707 403 551 549 402
362 1005 976 975 976 402 707 402 707 402 707 362 583 580 580 580 580 580 580 581 434 1005 323 398 339 707 403 707 403 583 581 338
338 1005 1006 1006 1006 434 739 402 707 402 707 362 973 974 974 974 974 974 974 974 974 1006 362 675 403 707 403 739 435 973 974 402
370 1005 1006 1006 1006 974 974 402 707 402 707 338 395 398 329 1005 1006 323 398 398 398 398 339 707 403 707 403 973 974 1006 1006 434
434 1005 1006 1006 1006 1006 1006 434 739 402 707 371 519 517 339 1005 1006 339 519 548 548 517 371 707 403 739 435 1005 1006 1006 1006 974
974 1006 1006 1006 1006 1006 1006 974 974 402 707 403 551 549 371 1005 1006 371 551 548 548 549 403 707 403 973 974 1006 1006 1006 1006 338
338 1005 1006 1006 1006 1006 1006 1006 1006 434 739 403 551 549 403 425 459 403 551 548 548 549 403 739 435 1005 1006 1006 1006 1006 1006 370
370 1005 1006 1006 1006 1006 1006 1006 1006 974 974 403 551 549 403 425 459 403 551 548 548 549 403 973 974 1006 1006 1006 1006 1006 1006 362
362 1005 1006 1006 1006 1006 1006 1006 1006 1006 1006 435 583 581 403 425 459 403 583 580 580 581 435 1005 1006 1006 1006 1006 1006 1006 1006 362
362 1005 1006 1006 1006 1006 1006 1006 1006 1006 1006 974 974 974 403 425 459 403 973 974 974 974 974 1006 1006 1006 1006 1006 1006 1006 1006 362
362 1005 1006 1006 1006 1006 1006 1006 1006 1006 1006 1006 1006 1006 435 425 459 435 1005 1006 1006 1006 1006 1006 1006 1006 1006 1006 1006 1006 1006 362
362 1005 1006 1006 1006 1006 1006 1006 1006 1006 1006 1006 1006 1006 1006 1006 1006 1006 1006 1006 1006 1006 1006 1006 1006 1006 1006 1006 1006 1006 1006 362
338 1005 1006 1006 1006 338 1005 1006 1006 338 1005 1006 1006 1006 339 1005 1006 339 1005 1006 1006 1006 338 1005 1006 1006 338 1005 1006 1006 1006 338
370 395 398 398 398 370 395 398 398 370 395 398 398 398 370 1005 1006 370 395 398 398 398 370 395 398 398 370 395 398 398 398 370
402 515 516 516 517 402 515 516 517 402 515 516 516 517 402 425 459 402 515 516 516 517 402 515 516 517 402 515 516 516 517 402
434 579 580 580 581 434 579 580 581 434 579 580 580 581 434 425 459 402 579 580 580 581 434 579 580 581 434 579 580 580 581 434
35 35 35 35 35 35 192 273 273 273 273 273 273 273 273 273 273 273 273 273 273 273 273 273 273 273 273 273 273 273 273 273
