FE5 - Fields (Dark)
30 32
66 66 66 66 66 66 66 66 66 66 66 66 66 66 66 66 66 66 66 66 66 66 66 66 66 66 66 66 66 66 66 66
66 66 868 66 66 868 66 66 868 66 69 868 66 66 868 66 66 836 900 66 868 66 66 868 66 66 868 66 66 868 66 66
66 66 66 66 66 66 66 70 82 82 71 78 70 82 71 66 66 66 66 66 3 3 3 3 3 3 3 66 66 66 66 678
66 66 66 66 66 66 66 47 102 38 38 38 38 38 860 858 861 66 70 71 66 66 66 66 66 66 3 3 772 772 66 710
653 66 66 3 3 3 3 100 100 102 38 38 38 38 892 890 893 82 38 38 175 69 69 69 69 69 772 772 66 678 716 713
717 66 772 772 66 66 100 100 66 69 113 38 38 114 924 922 925 114 721 103 164 164 721 721 741 772 772 164 678 711 711 718
617 653 721 66 66 66 721 69 69 3 102 38 103 66 113 38 103 3 66 66 66 880 881 882 721 66 164 164 710 711 718 682
718 717 66 741 772 772 69 66 66 66 69 113 71 164 102 38 71 66 3 3 721 912 913 914 786 787 164 678 711 711 712 682
682 682 653 66 66 69 721 721 66 66 69 102 81 164 721 102 38 82 80 66 741 944 945 946 818 819 721 742 711 711 711 617
617 717 66 66 880 881 882 721 721 721 69 66 102 71 66 66 102 38 71 64 64 786 787 721 880 881 882 721 742 711 711 648
648 682 653 721 912 913 914 721 786 787 721 66 164 47 66 721 66 113 38 71 66 818 819 164 912 913 914 721 66 710 711 648
718 717 3 721 944 945 946 3 818 819 721 164 786 787 721 772 772 113 38 103 721 721 721 721 944 945 946 721 678 711 711 712
617 682 653 721 786 787 721 772 772 786 787 772 818 819 64 70 82 38 103 164 721 721 721 772 772 721 721 100 710 711 711 711
718 749 3 721 818 819 64 64 64 818 819 164 721 773 740 102 38 38 71 772 772 721 721 721 721 66 721 66 742 711 711 713
717 66 66 3 721 880 881 882 772 772 721 64 721 66 66 66 102 38 81 66 66 721 721 66 786 787 66 66 100 742 711 718
749 66 66 66 721 912 913 914 66 786 787 772 772 721 78 75 70 38 38 71 772 772 721 721 818 819 772 772 772 164 710 712
66 66 66 772 772 944 945 946 64 818 819 164 66 721 102 82 38 103 102 114 71 721 880 881 882 3 69 69 69 66 742 647
66 66 66 66 772 772 741 772 66 741 772 3 741 772 772 113 38 721 772 772 102 175 912 913 914 69 772 772 772 772 721 710
66 66 3 3 66 66 66 69 66 66 66 66 164 3 164 113 721 38 71 164 66 109 944 945 946 721 3 66 66 66 66 710
66 772 772 772 772 772 66 66 66 69 164 164 164 164 721 102 114 38 38 82 80 66 66 786 787 721 64 64 64 772 772 742
66 3 721 66 66 66 66 772 772 164 66 69 164 164 69 69 69 113 38 81 3 3 3 818 819 3 772 772 66 64 64 721
66 3 772 772 772 772 66 164 721 66 66 772 772 673 741 772 721 102 38 103 69 69 69 721 786 787 66 721 3 66 66 66
71 3 77 721 66 164 164 66 721 66 66 66 66 164 69 69 14 69 113 80 3 741 772 772 818 819 69 3 66 66 66 66
38 82 175 66 76 78 70 71 772 772 66 69 69 164 164 70 38 82 38 71 69 69 721 69 721 740 741 69 69 66 740 741
103 102 82 82 71 113 38 38 71 78 78 77 3 3 70 38 114 114 38 38 71 66 721 721 721 69 69 69 772 772 66 66
66 103 110 102 114 103 102 114 103 103 102 82 71 70 38 38 71 100 102 114 38 71 772 772 721 772 3 66 66 66 66 196
3 3 772 772 673 741 772 721 164 64 64 102 103 113 38 38 38 175 64 66 102 114 175 721 772 772 3 741 772 772 196 53
52 3 66 69 69 66 66 772 772 66 66 721 70 38 38 38 81 109 100 100 100 66 109 66 66 66 3 3 196 196 53 212
212 52 64 64 64 64 64 66 66 721 66 66 113 38 38 38 38 71 15 64 64 741 772 772 64 64 64 196 53 117 212 244
212 212 117 52 66 66 66 66 66 66 66 70 38 38 38 38 38 38 103 69 69 3 3 66 66 196 53 117 212 244 213 213
