FE5 - Fields (Dark)
30 32
718 682 715 711 711 711 711 718 779 711 711 718 682 682 682 749 70 38 38 38 38 71 66 742 775 647 711 711 711 712 650 650
682 715 711 711 711 711 718 682 682 779 718 682 682 750 749 70 38 38 38 38 38 81 66 646 653 742 775 775 775 647 712 650
715 711 711 711 711 718 682 682 682 682 779 712 717 66 70 38 38 38 38 38 38 38 71 742 781 807 808 809 998 710 711 712
711 711 711 711 718 682 682 682 682 750 715 711 617 685 113 38 38 38 38 38 38 38 81 66 998 871 872 873 646 711 711 711
711 711 711 718 682 682 682 682 749 734 742 775 719 749 113 114 38 38 38 38 38 38 38 71 66 998 66 646 711 711 711 718
711 711 711 718 682 682 682 717 901 901 756 734 608 70 103 66 102 38 38 103 110 102 38 114 71 998 66 710 711 711 718 650
779 716 711 617 750 682 750 749 730 837 837 796 66 47 66 646 617 421 421 712 653 66 47 721 47 998 66 742 647 711 712 650
682 682 779 718 998 717 729 756 756 724 724 766 66 646 617 715 648 421 421 711 712 653 66 66 721 721 165 165 742 647 711 712
682 715 716 617 650 717 609 610 608 582 766 646 649 779 718 715 718 421 421 711 711 716 716 712 653 66 721 15 66 742 647 711
715 711 711 718 682 749 82 80 66 66 66 710 712 682 625 461 433 421 421 462 461 461 461 626 682 653 66 102 82 71 710 711
716 711 718 682 749 102 103 998 646 716 617 779 711 625 491 495 497 66 66 497 495 493 493 490 626 682 653 165 721 102 742 647
711 711 617 717 66 112 71 66 710 711 712 625 461 491 498 66 66 66 66 66 3 3 66 497 657 626 682 653 66 174 721 710
711 711 718 749 609 610 103 66 710 711 625 657 495 497 66 66 66 721 66 66 721 3 3 69 657 657 682 717 721 174 721 742
711 718 749 15 66 66 66 646 711 711 657 657 66 66 66 868 868 868 596 597 868 868 868 165 657 657 682 717 721 174 721 38
719 749 70 103 66 614 934 742 647 711 657 490 461 626 66 66 66 721 628 629 69 165 165 625 491 657 682 717 66 70 38 103
617 653 102 71 141 66 66 66 742 647 490 626 495 490 626 66 66 66 66 845 846 847 66 657 498 657 682 717 66 113 81 646
648 682 653 102 103 112 868 66 66 710 497 490 461 626 490 461 626 66 66 877 878 879 66 657 625 491 682 749 66 47 47 710
712 682 715 716 617 653 66 66 66 742 647 497 495 490 626 495 490 461 626 909 910 911 625 491 657 498 717 3 66 721 71 710
711 716 649 619 648 717 66 66 66 66 742 647 711 497 490 461 626 495 490 461 461 461 491 498 657 718 749 3 721 81 721 710
711 711 712 715 712 717 772 772 721 66 66 742 775 647 497 495 490 461 626 495 493 493 625 461 491 717 69 3 70 81 646 711
711 711 711 649 619 744 653 721 721 721 66 66 66 742 775 647 497 495 490 461 461 461 491 495 497 717 69 70 721 103 710 718
711 711 711 718 715 711 617 721 772 772 66 112 71 66 66 742 775 647 497 495 493 493 497 718 750 749 66 47 646 716 716 617
711 711 718 715 716 711 716 716 617 653 66 66 110 66 66 66 66 742 775 775 775 775 719 749 66 66 69 608 742 711 711 718
711 718 682 682 619 711 711 711 711 716 617 653 772 772 112 71 15 165 66 66 66 66 66 66 69 69 15 66 608 742 647 712
718 682 682 682 715 711 711 711 711 711 712 717 66 66 721 102 114 71 70 71 70 80 673 741 69 70 81 66 772 772 710 711
682 682 682 715 716 711 711 711 711 711 711 716 617 653 66 721 66 102 114 38 38 71 69 70 79 38 103 165 804 66 710 711
682 715 716 649 619 711 711 711 711 711 711 711 712 682 653 741 772 772 66 102 38 38 82 38 38 81 772 772 66 66 710 711
715 716 711 718 682 619 711 711 711 711 711 711 711 617 717 66 66 772 772 66 113 38 38 38 38 103 66 66 66 66 710 711
716 711 711 744 682 682 715 649 619 711 711 711 711 711 716 617 653 66 66 66 102 38 38 38 81 66 66 741 772 772 742 711
711 711 711 711 712 715 716 712 682 619 711 711 711 711 711 648 682 682 653 66 66 102 38 38 103 66 66 66 66 772 772 742
