FE5 - Fields (Green)
15 33
213 213 213 277 212 212 212 212 212 276 213 213 213 213 213 213 213 213 213 213 213 213 213 213 213 277 212 212 276 213 213 213 213
213 213 277 212 212 84 85 85 86 212 212 276 213 213 213 213 213 213 213 213 277 212 212 212 212 212 212 88 212 212 276 213 213
213 277 212 212 20 70 79 71 219 20 21 212 276 213 213 213 277 212 212 212 212 20 120 21 20 120 120 721 120 21 212 276 213
277 212 212 20 70 857 858 859 721 614 653 21 212 276 213 277 84 85 86 88 20 964 964 964 164 99 721 900 721 164 21 212 276
212 212 20 70 38 889 890 891 71 710 617 653 21 212 212 212 218 868 82 82 80 164 164 99 99 164 164 807 808 809 204 282 212
212 90 70 38 38 921 922 923 38 710 712 682 653 21 88 20 70 38 38 103 721 721 164 164 162 162 162 871 872 873 264 314 212
212 122 102 111 38 38 38 38 721 742 647 617 717 612 612 82 111 114 103 162 162 164 116 117 118 99 99 198 145 273 316 215 212
212 20 99 162 102 38 38 38 38 721 742 687 749 721 38 81 99 99 99 164 164 53 212 88 20 99 868 230 305 305 177 247 212
212 218 99 162 807 808 809 38 38 38 609 610 721 38 38 103 99 721 721 53 117 212 20 162 162 162 238 99 99 162 162 221 212
212 218 99 99 871 872 873 102 38 38 38 38 38 114 103 99 721 721 53 212 212 20 807 808 809 99 162 738 738 99 53 212 212
212 52 99 99 99 99 99 162 102 38 868 114 103 99 99 99 53 117 212 212 90 99 871 872 873 99 721 99 99 53 212 212 244
212 212 52 119 99 162 99 162 162 102 38 80 164 721 99 53 212 244 213 245 122 99 99 99 721 99 738 738 53 212 244 213 213
245 245 212 212 218 99 99 964 964 116 117 117 118 164 164 221 244 213 213 213 245 52 119 119 119 119 721 721 221 213 213 213 213
213 213 245 212 52 99 99 53 117 212 212 212 212 117 117 244 213 213 213 213 213 245 212 212 212 212 117 117 244 213 213 213 213
213 213 213 245 212 117 117 212 212 212 212 212 212 212 244 213 213 213 213 213 213 213 245 212 212 212 212 244 213 213 213 213 213
