FE5 - Fields
25 31
721 721 721 880 881 882 786 787 721 880 881 882 786 787 721 721 721 721 721 880 881 882 721 721 721 604 605 66 102 114 38
786 787 721 912 913 914 818 819 721 912 913 914 818 819 786 787 786 787 721 912 913 914 786 787 721 604 605 66 66 66 102
818 819 721 944 945 946 721 721 721 944 945 946 721 721 818 819 818 819 721 944 945 946 818 819 721 604 605 66 66 66 66
721 721 721 897 994 994 994 994 994 994 994 994 994 994 994 994 994 994 994 994 994 994 994 994 994 604 605 70 82 71 66
786 787 721 995 729 756 756 756 756 756 756 756 756 756 756 756 756 756 756 756 756 756 756 756 7 8 9 38 38 38 175
818 819 721 995 795 724 724 788 788 788 788 788 788 788 788 788 788 788 788 788 788 788 788 788 7 8 9 38 38 38 71
880 881 882 995 795 724 766 706 706 706 706 706 706 706 706 706 706 706 706 706 706 706 706 706 706 604 605 102 38 38 38
912 913 914 995 795 766 642 880 881 882 786 787 70 868 880 881 882 721 721 721 721 721 880 881 882 604 605 66 102 114 38
944 945 946 995 795 737 721 912 913 914 818 819 964 103 912 913 914 721 807 808 809 721 912 913 914 604 605 66 78 70 103
994 994 994 929 795 734 674 944 945 946 721 721 721 721 944 945 946 721 871 872 873 721 944 945 946 604 605 112 38 38 175
756 734 721 729 724 796 721 674 772 772 772 772 772 772 772 772 772 772 772 421 772 772 772 772 772 604 605 66 102 81 66
724 724 734 857 858 859 729 756 756 756 756 756 756 756 756 756 756 756 756 756 756 756 756 756 7 8 9 79 82 38 71
724 724 724 889 890 891 724 724 724 724 724 724 724 724 724 724 724 724 724 724 724 724 724 724 766 604 605 47 102 38 38
724 724 766 921 922 923 730 788 788 788 788 788 788 788 788 788 788 788 788 788 788 788 788 788 7 8 9 79 82 38 38
788 766 721 729 724 734 721 706 706 706 706 706 706 706 706 706 706 706 706 706 706 706 706 706 706 604 605 110 102 38 103
706 706 706 730 724 766 642 721 721 880 881 882 721 721 721 721 880 881 882 786 787 721 721 786 787 604 605 66 174 38 71
880 881 882 704 795 737 721 721 721 912 913 914 965 724 901 721 912 913 914 818 819 721 721 818 819 604 605 66 70 38 81
912 913 914 704 795 734 674 721 721 944 945 946 721 721 721 721 944 945 946 721 721 721 721 721 721 604 605 112 38 81 102
944 945 946 704 795 724 734 674 772 772 772 772 421 772 772 772 772 772 772 772 772 772 772 772 772 604 605 70 38 38 71
721 786 787 704 795 724 724 756 756 756 756 756 756 756 756 756 756 756 756 756 756 756 756 756 7 8 9 38 38 38 103
721 818 819 704 730 788 788 788 788 788 788 788 788 788 788 788 788 788 788 788 788 788 788 788 7 8 9 38 114 38 80
721 721 721 641 706 706 706 706 706 706 706 706 706 706 706 706 706 706 706 706 706 706 706 706 706 604 605 47 66 102 71
721 721 721 786 787 880 881 882 721 721 786 787 786 787 721 721 880 881 882 786 787 721 721 721 721 604 605 66 66 112 81
721 721 721 818 819 912 913 914 786 787 818 819 818 819 721 721 912 913 914 818 819 786 787 721 721 604 605 66 70 82 38
721 721 721 721 721 944 945 946 818 819 721 721 721 721 721 721 944 945 946 721 721 818 819 721 721 604 605 70 38 38 38
