FE5 - Fields (Dark)
30 32
212 220 66 66 66 66 66 102 38 38 38 38 38 103 66 66 66 102 114 38 38 38 38 38 38 114 38 38 103 66 66 66
212 220 66 66 66 66 66 66 113 38 38 38 38 71 772 772 66 66 66 102 38 38 38 38 103 66 102 103 66 66 66 66
212 220 66 66 66 66 66 66 102 38 38 38 114 38 82 71 100 772 772 70 38 804 38 103 69 66 66 66 66 66 772 772
212 212 52 66 772 773 3 3 3 102 103 173 3 102 103 110 109 112 82 38 38 38 103 165 69 69 69 66 66 66 66 66
245 212 212 52 100 3 3 772 773 3 3 66 772 772 66 868 69 70 38 103 110 110 162 162 162 162 162 162 66 737 772 772
213 245 212 212 52 66 66 66 737 772 772 66 66 66 66 66 162 102 38 80 162 3 66 3 3 100 772 772 772 66 66 53
213 213 213 212 212 117 117 52 165 165 772 772 772 165 66 66 66 174 103 772 772 772 737 772 772 100 66 66 66 66 53 212
213 213 213 245 212 212 212 212 52 66 66 162 66 162 66 66 66 66 66 100 100 165 165 3 3 53 117 117 117 117 212 244
213 213 213 213 213 213 245 212 212 117 117 117 117 117 288 289 117 117 117 117 117 117 117 117 117 244 212 212 212 212 244 213
213 213 213 213 213 213 213 213 245 212 212 212 212 244 225 226 212 212 212 212 212 245 212 212 244 213 213 213 213 213 213 277
213 213 213 213 213 213 213 213 213 213 245 212 244 213 225 226 245 212 212 244 213 213 213 213 213 213 277 276 213 213 277 212
213 213 213 213 213 213 213 213 213 213 213 213 213 213 225 226 213 213 213 213 213 277 276 213 213 277 212 212 276 277 212 212
213 213 213 213 213 213 213 213 213 213 213 213 277 212 225 226 212 212 212 212 212 212 212 212 212 212 212 212 212 212 84 85
213 213 213 213 213 213 213 213 213 213 277 212 84 85 320 321 85 85 85 85 85 85 85 85 85 85 85 85 86 20 66 66
213 213 213 213 213 213 213 213 213 213 245 220 100 66 162 162 162 66 66 100 100 66 162 162 162 66 66 69 729 756 734 66
213 213 213 213 213 213 213 213 213 213 213 245 52 66 162 162 868 66 66 100 162 162 66 66 66 112 82 759 901 724 837 734
213 213 213 213 213 213 213 213 213 213 213 212 212 52 162 162 162 162 162 162 3 100 66 66 66 66 102 795 724 997 724 796
213 213 213 213 213 213 213 213 213 213 213 213 245 212 288 289 117 117 117 117 117 117 117 117 52 66 66 730 837 724 901 766
213 213 213 213 213 213 213 213 213 213 213 213 213 213 225 226 212 212 212 212 212 212 212 212 212 117 117 52 730 788 766 66
213 213 213 213 213 213 213 213 213 213 213 213 213 277 225 226 212 212 212 212 88 212 212 212 212 212 212 212 52 66 66 66
213 213 213 213 213 213 213 277 212 212 212 212 212 212 225 226 212 212 212 20 69 21 88 212 212 212 245 212 212 117 52 119
213 213 213 213 277 212 212 212 88 212 212 212 85 86 320 321 84 86 20 66 66 66 66 21 212 276 213 245 212 212 212 212
213 277 212 212 212 84 86 20 162 21 20 66 721 66 3 66 66 66 165 165 721 66 66 721 221 212 276 213 213 213 245 212
277 212 84 86 20 721 66 69 66 66 66 738 738 721 162 66 721 738 738 165 740 672 706 66 21 212 212 212 212 276 213 213
212 20 721 3 66 673 738 69 66 3 3 3 100 66 66 162 162 721 66 721 165 165 66 66 721 21 84 86 212 212 276 213
220 162 66 3 3 3 3 3 677 672 721 165 66 100 15 868 721 100 162 70 71 165 71 100 3 100 721 721 21 84 85 85
212 52 100 676 675 721 772 772 100 100 100 165 721 112 38 71 78 103 112 114 38 82 38 71 78 66 857 858 859 66 66 721
212 220 66 66 66 3 69 66 675 676 165 66 66 70 38 114 721 66 66 66 102 721 38 38 38 80 889 890 891 66 66 721
212 220 66 868 868 868 868 66 721 66 165 721 66 113 103 100 66 66 66 66 66 66 102 114 38 71 921 922 923 71 721 66
213 212 52 66 66 69 66 3 66 165 165 66 70 38 71 66 100 100 66 66 66 3 66 721 102 38 38 721 38 38 80 721
