FE5 - Castle v2 (Green)
30 32
339 395 398 399 1006 1006 1006 396 398 398 398 398 398 329 33 35 35 35 35 35 35 323 398 398 399 1005 1006 1006 396 398 329 33
362 640 641 642 1006 1006 1006 640 641 642 640 641 642 362 33 35 35 35 35 35 35 362 640 641 642 1005 1006 1006 640 641 362 33
362 947 951 951 951 951 951 951 952 1006 1006 1006 1006 339 33 35 35 35 35 35 35 339 1005 974 974 1006 1006 1006 974 974 362 33
362 979 983 983 983 983 983 983 984 1006 1006 1006 1006 362 33 35 35 35 35 35 35 362 1005 950 951 951 951 951 952 1006 362 33
362 979 983 983 983 983 983 983 984 1006 323 398 398 388 398 398 399 1005 396 398 398 388 398 398 339 979 983 983 984 1006 362 33
362 1011 1015 1015 1015 1015 1015 1015 1016 1006 362 640 641 641 641 641 642 1005 640 641 641 641 641 642 362 1011 1015 1015 1016 1006 362 33
362 1005 1006 1006 1006 1006 1006 1006 1006 1006 362 973 974 974 974 974 974 1006 974 974 974 974 974 974 362 1005 1006 1006 1006 1006 362 33
339 395 398 398 399 1006 396 398 398 398 361 1005 1006 1006 1006 1006 1006 428 1005 1006 1006 1006 1006 1006 362 1005 1006 1006 1006 1006 362 33
362 640 641 641 642 400 640 641 641 642 339 1005 1006 339 395 398 329 428 323 398 398 339 1005 1006 339 1005 1006 1006 1006 1006 339 33
362 973 974 974 974 974 974 974 974 974 362 1005 1006 362 461 950 362 947 362 948 461 362 1005 1006 355 398 399 1005 396 398 361 33
362 1005 950 951 951 951 951 951 952 1006 362 1005 1006 362 1005 982 362 979 362 980 1006 362 1005 1006 362 641 642 400 640 641 362 33
362 1005 982 983 983 983 983 983 984 1006 339 1005 1006 362 1005 982 362 979 362 980 1006 362 1005 1006 339 1005 974 974 974 974 362 33
362 1005 982 983 983 983 983 983 984 1006 362 1005 1006 362 1005 982 362 979 362 980 1006 362 1005 1006 362 1005 950 951 952 1006 362 33
362 1005 1014 1015 1015 1015 1015 1015 1016 1006 362 1005 1006 362 1005 1014 394 1011 394 1012 1006 362 1005 1006 362 1005 982 983 984 1006 362 33
339 1005 1006 461 1006 1006 1006 461 1006 1006 339 1005 1006 362 1005 1006 974 1006 974 1006 1006 362 1005 1006 339 1005 1014 1015 1016 1006 339 33
371 395 398 398 399 1006 396 398 398 398 371 1005 1006 339 320 321 322 855 320 321 322 339 1005 1006 362 1005 1006 1006 1006 461 362 33
435 640 641 641 642 400 640 641 641 642 435 1005 1006 371 384 385 390 398 389 385 386 371 1005 1006 355 398 399 1005 396 398 361 33
974 974 974 974 974 974 974 974 974 974 974 1006 1006 403 525 526 515 516 517 527 528 403 1005 1006 339 641 642 400 640 641 362 33
1006 1006 1006 1006 1006 1006 1006 1006 1006 1006 1006 1006 1006 435 557 558 579 580 581 559 560 435 1005 1006 362 973 974 974 974 974 362 338
1006 1006 1006 1006 1006 1006 1006 1006 1006 1006 339 1005 1006 974 974 974 974 974 974 974 974 974 1006 1006 394 1005 1006 1006 1006 1006 362 338
1006 1006 1006 339 395 398 398 398 398 398 371 1005 1006 1006 1006 1006 1006 1006 1006 1006 1006 1006 1006 1006 1006 1006 1006 1006 1006 1006 339 370
1006 1006 1006 362 640 641 641 641 641 642 435 1005 339 395 398 398 398 398 399 1006 396 339 395 398 398 398 398 398 398 398 371 402
1006 1006 1006 362 973 974 974 974 974 974 974 1006 362 640 641 641 641 641 642 400 640 362 640 641 641 641 641 641 641 641 435 434
399 1006 396 362 1005 1006 1006 1006 1006 1006 1006 1006 362 973 974 974 974 974 974 974 974 362 973 974 974 974 974 2 2 2 2 2
642 400 640 339 1005 1006 1006 1006 1006 1006 1006 1006 339 1005 1006 1006 1006 1006 1006 1006 1006 339 1005 1006 1006 1006 1006 35 35 35 35 35
974 974 974 371 395 398 398 398 398 398 398 398 371 1005 1006 1006 1006 1006 1006 1006 1006 371 399 1005 1006 396 339 33 35 562 35 35
1006 1006 1006 435 640 641 641 641 641 641 641 642 435 1005 1006 1006 1006 330 1005 1006 1006 435 642 1005 1006 640 362 33 562 531 562 35
1006 1006 1006 1006 1006 1006 1006 1006 1006 1006 1006 1006 1006 1006 1006 1006 1006 362 1005 1006 1006 1006 1006 1006 1006 1006 339 33 35 562 35 35
398 398 398 398 398 398 398 398 398 398 398 398 398 398 398 398 398 388 398 398 398 398 398 398 398 398 371 33 35 35 35 35
641 641 641 641 641 641 641 641 641 641 641 641 641 641 641 641 641 641 641 641 641 641 641 641 641 641 435 33 35 35 35 35
