FE5 - Castle v2 (Blue)
28 28
453 453 453 454 362 877 878 878 878 878 878 878 878 878 878 878 878 878 878 878 394 419 420 421 421 421 421 421
453 453 453 454 394 877 878 878 878 878 878 878 878 878 878 878 878 878 878 878 336 451 484 485 485 485 485 485
453 453 485 454 337 878 878 878 878 878 878 878 878 878 878 878 878 878 878 878 368 489 490 490 490 490 490 490
485 485 422 491 369 877 878 339 395 398 399 877 878 878 396 398 398 339 877 878 355 398 398 398 398 398 398 398
490 490 491 323 393 877 878 371 640 641 642 425 458 459 640 641 642 371 877 878 394 419 420 421 421 421 421 421
398 398 398 393 845 878 878 330 973 974 974 457 458 459 973 974 974 330 877 878 336 451 484 485 485 485 485 485
846 846 846 846 878 878 878 362 1005 1006 1006 974 974 974 1006 1006 1006 362 877 878 368 489 490 490 490 490 490 490
878 878 878 878 878 878 878 362 1005 1006 950 951 951 952 1006 1006 1006 362 877 878 355 398 398 398 398 398 398 398
398 398 339 877 323 398 398 388 339 1005 982 983 983 886 951 952 1006 362 877 878 394 419 420 421 421 421 421 421
846 846 371 877 362 845 846 846 371 1005 982 983 983 983 983 984 1006 362 877 878 336 451 484 485 485 485 485 485
878 878 330 877 387 329 877 878 330 1005 982 983 983 983 983 984 1006 362 877 878 368 489 490 490 490 490 490 490
878 878 339 877 878 362 877 878 362 1005 982 983 983 983 983 984 1006 362 877 878 384 398 398 398 398 398 398 398
878 878 371 877 323 393 877 878 362 1005 982 983 983 983 983 984 1006 339 877 878 846 846 846 846 846 846 846 846
878 878 330 877 362 845 878 878 362 1005 1014 1015 1015 1015 1015 1016 1006 371 877 878 878 878 878 878 878 878 878 878
878 878 339 877 387 329 878 878 362 1005 1006 1006 1006 1006 1006 1006 1006 320 321 321 321 321 321 321 321 321 321 321
878 878 371 877 846 362 878 878 362 1005 1006 1006 1006 1006 1006 1006 1006 384 385 385 385 385 385 385 385 385 385 385
878 878 330 877 323 393 878 878 339 1005 1006 1006 1006 1006 1006 1006 1006 974 974 974 974 974 974 974 974 974 974 974
878 878 339 877 362 845 878 878 371 320 321 321 322 339 1005 1006 1006 1006 1006 1006 1006 1006 1006 1006 1006 1006 1006 1006
878 878 371 877 362 877 878 878 396 389 385 385 386 371 1005 1006 1006 1006 1006 1006 1006 1006 1006 1006 1006 1006 1006 1006
398 398 399 877 339 877 878 878 878 878 878 878 878 320 321 321 321 321 321 321 321 321 321 321 321 321 321 321
846 846 846 878 371 877 878 878 878 878 878 878 878 384 385 385 385 385 385 385 365 385 385 385 385 385 385 385
878 878 878 878 396 398 398 398 398 398 399 877 878 846 846 846 846 846 846 846 362 419 420 421 421 421 421 421
398 329 878 878 846 846 846 846 846 846 846 878 878 878 878 878 878 878 878 878 394 451 452 453 453 453 453 453
422 387 329 878 878 878 878 878 878 878 878 878 878 323 398 398 398 419 420 421 421 421 453 453 453 453 453 453
421 422 387 398 398 398 398 398 398 398 329 877 878 362 419 420 421 421 453 453 453 453 453 453 453 453 453 453
453 421 421 421 421 421 421 421 421 422 394 877 878 362 451 452 453 453 453 453 453 453 453 453 453 453 453 453
453 453 453 453 453 453 453 453 453 454 337 878 878 362 451 452 453 453 453 453 453 453 453 453 453 453 453 453
453 453 453 453 453 453 453 453 453 454 369 877 878 362 451 452 453 453 453 453 453 453 453 453 453 453 453 453
