FE5 - Fields
30 16
617 653 66 174 71 738 738 66 66 706 706 66 721 742 711 711
718 682 653 70 38 175 66 66 66 66 66 800 706 721 742 711
682 682 749 102 868 78 78 70 82 71 78 130 66 66 998 742
682 749 608 130 102 111 38 38 38 38 38 71 66 900 721 721
717 608 608 130 130 66 102 114 38 103 102 38 71 721 721 66
717 608 608 721 130 608 70 79 804 721 82 38 103 66 721 998
717 608 721 66 721 130 113 71 721 721 102 114 71 721 614 716
717 608 721 66 112 43 608 721 38 103 66 998 66 71 66 710
717 608 133 174 82 79 38 38 103 133 614 718 413 484 413 711
717 608 66 174 38 38 38 721 130 614 713 717 70 81 66 710
717 608 721 70 38 114 103 99 614 713 718 717 102 81 66 710
717 608 66 102 38 71 130 721 710 718 682 749 66 102 175 742
717 608 721 174 38 103 99 614 718 682 749 99 99 106 107 66
717 608 608 721 102 175 133 710 617 717 66 66 807 808 809 79
682 653 608 608 133 66 678 711 718 717 66 99 871 872 873 114
682 717 133 721 66 66 66 742 649 779 716 653 66 130 130 66
617 682 653 608 608 66 66 99 608 721 742 716 716 716 716 716
718 682 749 998 608 66 99 78 721 66 721 721 742 775 711 711
682 749 608 608 66 99 99 113 79 79 71 721 721 66 742 711
749 868 66 608 608 608 70 38 38 38 38 79 71 133 721 710
744 653 66 66 608 608 868 721 38 38 38 38 103 66 721 710
711 617 653 66 738 738 102 114 38 38 38 721 71 721 721 710
711 718 749 66 66 738 738 721 102 38 38 38 103 721 721 710
718 717 66 998 608 66 721 66 70 38 38 103 66 721 678 711
750 749 721 66 66 738 738 738 110 102 721 66 66 998 742 711
617 653 721 721 721 66 66 66 721 857 858 859 66 66 868 710
712 682 653 721 868 721 66 66 66 889 890 891 66 66 678 711
619 744 682 653 721 721 66 66 721 921 922 923 721 66 721 710
617 619 716 716 617 653 721 721 66 174 38 721 66 721 678 711
718 715 711 711 648 682 653 998 721 70 38 103 66 721 710 711
