FE5 - Fields
15 32
66 66 957 958 959 71 21 212 20 721 38 71 91 212 276 213 213 213 213 277 212 212 20 70 38 38 71 66 66 25 276 213
66 66 989 990 991 38 71 600 807 808 809 103 123 212 212 276 213 213 277 212 212 20 70 38 38 38 103 66 66 721 91 276
66 70 1021 1022 1023 38 103 2 871 872 873 66 21 212 212 212 276 213 87 212 90 70 38 114 103 868 721 66 721 66 123 212
112 38 38 38 38 103 66 600 66 66 66 721 219 212 212 84 86 20 15 91 122 102 721 66 66 66 119 53 52 53 212 244
66 102 38 38 38 721 66 600 721 66 15 119 53 212 20 70 79 79 81 123 212 52 721 66 119 53 212 212 212 212 244 213
66 721 102 868 81 66 66 600 66 70 38 21 212 212 218 38 804 113 81 21 212 87 117 34 212 212 212 212 212 244 213 213
612 66 66 38 38 71 66 2 82 38 38 71 21 212 218 38 238 102 114 103 600 66 120 15 221 283 315 212 212 213 213 213
653 66 66 102 114 143 66 600 38 103 110 102 79 2 82 38 175 66 66 66 2 66 868 38 21 246 316 215 212 213 213 213
682 685 596 570 570 34 570 634 34 570 597 66 102 600 102 38 175 596 570 570 629 66 102 114 71 91 246 247 244 213 213 213
682 717 600 66 66 66 66 66 66 66 600 66 66 600 70 721 109 600 66 66 66 721 66 70 38 91 212 244 213 213 213 213
813 749 600 612 66 66 66 66 900 66 2 66 66 2 114 103 66 2 66 66 70 38 82 38 103 188 212 276 213 213 213 213
570 570 598 646 776 66 66 66 238 66 600 66 66 600 66 66 66 600 66 804 38 38 38 38 53 212 212 212 276 213 213 213
618 619 711 711 680 653 721 804 66 66 628 570 570 634 570 570 34 634 597 70 38 38 38 103 91 212 212 212 212 276 213 213
617 618 619 711 712 618 775 776 685 66 66 66 66 66 66 66 66 66 600 113 38 38 103 66 91 212 84 86 87 212 276 213
712 618 618 619 711 744 684 712 618 653 614 775 652 653 614 775 652 653 600 102 38 38 71 66 91 20 66 66 66 21 212 276
