FE5 - Fields
18 32
71 131 131 960 0 773 769 66 66 66 600 66 742 775 711 711 711 711 711 711 711 718 682 682 682 619 711 744 682 682 682 682
38 71 131 131 66 37 66 70 71 131 600 131 66 66 742 711 711 711 711 711 718 682 682 682 682 682 619 711 617 682 682 682
38 114 71 70 807 808 809 38 38 80 2 131 131 131 133 710 711 711 711 711 617 682 682 682 682 750 749 742 712 682 750 749
103 66 111 111 871 872 873 38 103 66 600 66 70 71 133 742 711 711 711 711 718 682 682 682 749 133 131 998 710 680 66 66
738 738 738 738 102 38 38 103 66 66 600 112 38 81 66 66 742 711 649 619 777 682 682 749 37 721 66 131 742 719 66 70
119 66 66 131 786 787 38 71 596 570 605 66 102 38 79 71 37 710 718 682 619 718 749 133 133 786 787 37 131 131 66 102
220 119 66 131 818 819 102 103 600 131 600 738 738 102 38 38 71 742 777 750 715 680 133 131 131 818 819 37 70 79 71 70
245 212 218 66 133 133 37 596 629 133 628 570 535 112 103 110 102 71 37 66 742 719 998 131 15 74 78 70 111 38 38 38
213 245 52 133 119 119 53 564 66 66 131 131 628 535 37 133 133 721 721 82 71 66 131 868 38 82 38 103 131 102 111 38
213 213 245 34 245 245 245 245 52 131 66 133 66 628 570 535 66 133 721 38 38 71 868 37 102 38 81 786 787 66 131 102
120 120 120 133 21 276 213 213 245 52 119 133 66 70 71 600 37 786 787 721 721 103 37 612 612 102 38 818 819 66 66 70
70 79 79 868 66 21 276 213 213 245 220 119 37 868 81 600 721 818 819 721 66 614 716 617 653 998 102 103 66 721 66 102
38 103 102 114 80 66 21 276 213 213 245 245 218 113 38 2 78 78 721 721 66 710 711 712 683 716 744 653 66 66 66 66
38 80 957 958 959 133 133 120 120 21 276 245 218 142 81 600 102 114 38 80 998 710 711 711 716 718 619 716 617 653 614 617
103 66 989 990 991 131 15 70 71 219 245 20 131 102 103 600 738 738 102 131 131 742 711 711 711 617 683 711 712 683 711 648
133 66 1021 1022 1023 70 38 103 868 66 2 131 131 66 596 629 133 66 66 131 614 616 742 711 711 680 650 619 711 649 779 718
738 738 66 131 70 38 81 66 119 53 212 52 119 53 564 133 133 131 614 716 711 712 653 742 711 712 650 683 711 711 718 650
738 738 738 66 102 38 103 53 212 244 213 245 212 212 212 52 66 66 710 711 711 711 716 716 711 711 617 650 619 711 617 650
