FE5 - Fields
31 21
131 131 21 212 212 212 244 213 213 245 52 131 174 38 38 38 38 103 131 131 131
131 131 131 21 212 244 213 277 276 277 88 218 174 38 38 38 81 738 738 131 131
131 131 131 219 212 213 277 20 21 212 218 131 174 38 38 38 103 786 787 721 131
131 131 131 219 212 90 120 131 131 120 131 140 72 38 38 143 131 818 819 721 131
131 131 70 71 21 122 131 131 131 807 808 809 114 38 38 38 71 721 721 721 131
131 70 38 81 131 21 52 131 131 871 872 873 131 102 114 38 38 71 738 738 738
79 38 38 103 738 738 21 52 119 119 131 131 131 131 131 142 38 81 131 131 131
38 114 103 198 868 131 131 21 212 212 52 131 131 131 131 102 114 114 80 131 131
38 71 131 300 301 738 738 131 21 212 212 52 119 119 131 131 868 868 868 131 131
38 38 71 268 269 131 131 131 53 212 244 245 212 212 52 131 238 238 238 131 131
38 38 103 230 868 199 131 219 212 244 213 213 245 212 212 52 119 4 119 119 119
38 38 71 131 300 301 131 53 212 213 213 213 213 245 212 212 212 36 213 213 213
38 38 38 71 131 131 53 212 244 213 213 213 625 461 461 461 353 484 352 461 626
38 38 38 103 131 131 91 212 213 213 213 213 657 547 548 548 548 548 548 548 657
38 38 81 131 131 131 123 244 213 213 213 213 657 579 516 516 516 516 516 516 657
38 38 103 131 131 53 212 213 213 213 213 213 657 579 516 516 516 516 516 516 657
38 103 131 131 131 91 212 213 213 213 625 430 466 579 516 516 516 516 516 516 657
47 131 131 131 131 123 212 213 213 213 657 547 548 516 516 516 516 516 625 461 491
119 119 119 119 53 212 244 213 213 213 657 579 516 516 516 516 516 516 657 384 385
212 212 212 212 212 212 213 213 213 213 657 579 516 516 516 516 516 516 657 377 377
212 212 212 212 212 212 276 213 213 213 657 579 516 516 516 516 516 516 657 212 244
120 120 120 120 120 120 21 276 213 213 657 579 516 516 516 516 516 516 657 244 213
15 131 131 131 70 71 804 21 276 213 490 461 461 353 484 352 461 461 491 212 276
38 71 786 787 113 38 71 131 21 276 384 528 528 385 513 384 528 528 385 212 244
38 38 818 819 721 103 131 131 131 21 377 377 377 377 4 377 377 377 377 244 213
114 38 38 77 786 787 131 131 131 131 120 120 21 212 68 21 212 212 276 213 213
131 47 110 107 818 819 738 738 738 131 131 131 131 120 131 219 212 212 212 276 213
131 131 786 787 721 738 738 131 721 721 721 131 131 131 15 219 212 212 212 276 276
131 131 818 819 131 131 70 82 103 786 787 721 131 70 81 131 120 120 120 120 21
131 738 738 131 131 131 102 38 71 818 819 721 721 38 721 804 131 131 721 131 53
131 131 738 738 738 131 131 102 38 721 721 721 38 38 71 131 131 131 131 53 213
