FE5 - Castle v2
22 16
311 311 311 311 338 338 384 385 385 385 385 385 385 386 338 338
311 311 311 311 434 434 580 580 580 822 823 824 580 580 434 434
311 311 311 311 320 322 950 951 951 853 855 856 947 952 320 322
398 398 398 398 389 386 982 983 983 457 458 459 979 984 352 354
951 951 951 951 951 951 885 983 983 983 983 983 983 984 352 354
983 983 983 983 983 983 983 983 983 983 983 983 983 984 352 354
983 983 983 983 983 983 983 983 983 983 983 983 983 984 352 354
1015 1015 1015 1015 1015 1015 983 983 983 983 983 983 983 984 352 354
398 398 398 398 338 338 1015 1015 1015 1015 1015 1015 1015 1016 338 338
212 212 212 149 434 434 398 339 398 398 400 398 398 339 434 434
311 311 311 277 212 212 212 371 950 951 951 951 952 371 212 212
311 311 311 311 311 311 311 330 982 983 983 983 984 330 311 311
311 311 311 311 311 311 311 362 982 983 983 983 984 362 311 311
311 311 311 311 311 311 311 362 982 983 983 983 984 362 311 311
311 311 311 311 311 311 311 362 982 983 983 983 984 362 311 311
311 311 311 311 311 311 311 362 982 983 983 983 984 362 311 311
311 311 311 311 311 311 311 362 982 983 983 983 984 362 311 311
339 320 321 321 321 321 321 367 982 983 983 983 984 362 311 311
371 384 385 385 385 385 385 386 982 983 983 983 984 362 311 311
330 950 951 951 951 951 951 951 885 983 983 983 984 362 311 311
362 982 983 983 983 983 983 330 983 983 983 983 984 362 311 311
339 982 339 395 398 398 398 388 398 398 398 398 398 339 311 311
