FE5 - Fields
19 28
102 38 38 38 38 103 130 130 130 738 738 738 130 53 212 244 245 212 218 67 102 38 38 103 67 67 67 53
108 868 47 102 81 130 130 130 738 738 130 130 53 244 212 213 213 124 67 67 99 102 103 99 67 67 53 244
130 738 738 70 103 130 738 738 738 738 738 130 91 212 244 213 213 245 52 67 99 130 130 67 119 53 244 213
164 164 70 38 82 77 130 130 164 164 130 130 123 212 213 213 213 213 245 52 119 4 4 53 212 244 213 213
130 70 38 38 103 164 130 164 130 130 130 53 212 244 213 213 213 213 213 245 212 36 36 212 212 276 213 213
112 38 38 81 164 738 738 738 738 130 53 212 244 213 213 213 213 213 213 277 24 68 68 120 120 21 276 213
130 102 38 38 71 738 738 130 130 53 212 244 213 213 213 213 213 213 277 24 130 130 15 130 130 130 21 276
130 130 113 38 103 130 130 130 53 212 244 213 213 213 213 213 213 277 24 130 130 70 81 130 738 738 130 21
119 119 4 4 119 119 119 53 212 244 213 213 213 213 277 276 277 24 130 130 130 142 143 738 738 130 130 99
212 213 36 36 212 212 212 212 244 213 213 213 213 277 24 21 212 218 130 70 82 38 81 78 75 786 787 99
25 87 68 68 212 212 212 276 213 213 213 213 277 24 738 738 120 130 112 38 38 38 38 38 804 818 819 99
164 130 74 141 120 120 120 21 276 213 213 277 24 130 721 721 786 787 164 113 38 38 38 38 38 868 786 787
71 164 174 169 130 130 804 130 21 276 277 24 130 130 786 787 818 819 70 38 38 38 38 103 110 868 818 819
38 71 136 73 78 78 15 131 219 212 212 52 130 804 818 819 721 721 38 38 114 38 81 130 130 786 787 99
114 38 38 786 787 38 38 71 130 21 212 124 130 738 738 738 738 721 38 103 70 38 103 130 130 818 819 99
130 102 103 818 819 38 114 38 82 7 8 9 130 15 164 140 70 38 38 71 102 38 71 130 738 738 130 130
721 131 130 164 102 103 164 102 38 7 8 9 130 102 82 38 38 38 38 114 71 102 38 80 130 738 738 99
786 787 164 786 787 164 164 130 47 21 212 122 130 804 38 38 38 38 81 804 173 108 103 130 130 130 130 130
818 819 130 818 819 164 164 130 130 53 212 212 52 130 102 38 38 38 103 164 130 164 164 130 130 130 130 130
