FE5 - Castle v2 OG (Dark)
17 19
750 362 982 983 983 983 983 984 362 982 983 983 981 983 402 750 750 750 362
750 387 329 982 983 983 983 984 362 1014 1015 1015 1013 1015 434 750 750 750 362
750 750 394 982 983 983 983 984 387 398 398 399 400 396 398 398 398 398 361
750 750 750 982 983 983 983 886 951 951 951 951 951 951 951 951 952 750 362
330 750 750 982 983 983 983 983 983 983 983 983 983 983 983 983 984 323 339
387 329 750 982 983 983 983 983 983 983 983 983 983 983 983 983 984 362 371
750 387 324 398 329 983 983 323 398 329 979 983 983 983 983 983 984 362 435
750 750 362 683 362 1015 1015 362 683 362 1011 1015 1015 1015 1015 1015 1016 362 1006
398 398 393 715 339 749 750 339 715 387 398 398 398 398 329 749 750 362 1006
515 516 517 148 371 425 459 371 149 515 516 517 515 516 339 398 398 339 1006
579 580 581 153 403 425 459 403 154 579 580 581 579 580 371 516 516 371 1006
1006 1006 1006 1006 435 425 459 435 1006 1006 1006 1006 1006 1006 435 580 580 435 1006
1006 1006 1006 1006 1006 1006 1006 1006 1006 1006 1006 1006 1006 1006 1006 1006 1006 1006 1006
1006 1006 1006 148 149 1006 1006 148 149 1006 1006 1006 1006 1006 1006 1006 1006 1006 1006
212 212 212 276 154 1006 1006 153 277 212 212 212 212 212 212 212 212 212 212
244 244 244 244 181 1006 1006 180 244 244 244 244 244 244 244 244 244 244 244
1006 1006 1006 1006 1006 1006 1006 1006 1006 1006 1006 1006 1006 1006 1006 1006 1006 1006 1006
