FE5 - Fields (Green)
24 32
818 819 721 721 66 741 772 66 66 70 103 66 600 807 808 809 172 173 66 66 35 37 37 37 15 37 772 740 66 66 66 66
787 786 787 721 772 673 66 66 35 110 66 66 600 871 872 873 66 66 35 35 37 37 112 82 114 71 66 70 807 808 809 66
819 818 819 721 66 66 66 77 35 66 66 66 600 102 111 66 66 66 37 37 66 77 66 47 66 113 82 114 871 872 873 66
721 721 721 66 37 66 70 175 66 66 66 66 628 597 66 66 66 66 37 37 70 175 66 786 787 110 102 70 38 38 103 66
741 772 66 66 37 37 102 107 66 66 66 772 673 628 597 66 70 71 35 15 102 107 66 818 819 66 112 114 38 81 66 66
772 673 66 66 857 858 859 37 66 786 787 66 66 66 600 174 38 103 66 113 71 15 66 66 77 66 35 70 38 103 66 66
66 66 66 66 889 890 891 37 37 818 819 721 66 596 605 66 110 721 112 38 38 38 71 70 175 35 35 113 103 66 66 66
66 66 66 66 921 922 923 66 66 786 787 721 596 629 600 772 66 721 66 102 38 38 38 103 35 66 70 103 66 66 66 66
37 35 786 787 772 35 66 66 66 818 819 596 629 66 600 66 66 66 66 174 103 113 103 37 37 35 102 80 66 66 66 66
37 74 818 819 70 79 71 35 66 66 596 629 66 66 628 597 66 66 35 35 112 103 66 66 37 37 70 71 70 75 66 66
37 70 721 721 38 103 47 35 66 66 600 66 35 66 66 628 597 66 672 740 672 66 66 66 66 66 113 38 38 175 66 66
70 38 38 38 38 80 35 66 66 66 600 35 35 71 78 75 628 570 597 66 66 66 786 787 112 82 38 38 81 35 66 66
103 113 38 38 38 71 78 66 66 596 629 35 35 113 103 66 66 66 628 597 66 66 818 819 66 102 38 103 113 71 35 66
66 47 102 38 38 114 103 66 596 629 66 66 112 38 71 77 35 66 66 628 570 597 66 66 66 35 102 112 114 38 80 35
66 66 70 38 103 66 66 66 600 66 66 66 66 102 38 175 35 66 740 738 66 628 570 597 66 35 66 66 174 143 66 66
66 112 81 47 66 66 66 66 600 66 673 741 673 174 143 66 35 35 66 66 66 66 66 628 597 672 740 672 70 103 37 37
66 14 47 66 66 721 66 66 600 66 66 66 66 106 786 787 66 35 66 66 66 66 66 66 600 37 37 37 142 80 66 66
44 38 71 66 786 787 66 596 629 66 66 70 79 71 818 819 721 66 35 66 66 66 66 66 600 66 35 66 142 71 66 66
108 102 103 66 818 819 596 605 66 66 174 114 38 38 721 786 787 66 35 35 66 66 66 66 600 66 35 70 38 38 175 66
66 35 66 673 741 673 604 629 66 66 106 112 38 38 721 818 819 140 78 75 66 66 66 66 600 66 35 142 103 102 107 66
66 66 35 66 66 66 600 66 66 35 15 70 38 38 38 82 175 66 102 80 35 66 66 66 628 597 740 110 173 70 103 66
66 66 35 35 66 66 2 66 35 35 102 114 38 38 38 103 107 37 66 35 66 35 66 66 66 2 66 66 66 102 141 66
66 66 66 66 572 596 629 66 35 66 35 70 81 102 103 66 66 37 37 37 37 37 37 37 66 628 597 66 66 70 175 66
66 66 66 596 666 629 66 66 35 35 70 38 103 66 66 66 66 35 66 66 66 66 35 35 66 66 628 597 66 102 175 66
