FE5 - Fields (Green)
32 32
711 711 718 682 749 742 647 648 750 715 648 750 750 750 715 647 711 711 718 717 66 66 66 70 71 66 66 646 711 711 711 681
711 718 682 749 70 71 742 719 66 742 719 66 66 3 608 710 711 718 682 717 37 37 37 142 143 66 66 710 711 711 711 648
648 682 749 66 113 103 66 66 66 66 66 66 66 165 678 711 718 715 712 682 653 3 66 932 103 37 608 710 711 711 711 718
718 717 608 44 38 77 66 66 66 66 165 165 165 165 710 711 649 619 711 712 682 653 3 66 721 646 681 619 711 711 718 682
716 617 653 70 38 109 165 66 678 617 653 37 3 66 710 711 718 682 619 711 617 682 653 786 787 710 712 682 619 718 715 716
711 718 749 38 114 45 66 608 710 648 717 37 66 66 710 711 712 682 715 711 648 682 749 818 819 742 647 712 682 682 619 711
718 717 721 38 71 786 787 998 710 648 717 66 66 66 742 711 711 716 649 619 718 749 66 66 37 721 742 647 716 712 682 619
682 717 71 113 721 818 819 66 710 718 749 786 787 66 678 711 711 711 718 682 749 3 3 66 70 82 175 742 647 647 712 682
617 717 102 38 721 721 165 678 718 717 721 818 819 721 742 647 711 718 682 749 165 165 165 70 38 38 71 66 608 710 711 712
648 717 70 38 38 103 608 710 617 717 140 75 66 678 716 711 718 682 749 165 165 165 165 47 102 114 81 35 35 742 647 711
718 717 721 38 81 66 678 711 648 749 113 109 66 742 647 718 682 717 786 787 70 82 71 66 66 35 113 71 35 37 742 711
682 682 653 721 38 71 710 711 648 653 38 71 70 175 742 617 682 749 818 819 38 38 81 37 66 35 102 38 175 66 37 710
715 716 617 721 38 81 742 711 712 749 102 38 38 175 678 712 682 653 721 721 721 81 46 37 70 71 66 113 175 66 646 711
749 742 648 721 38 103 710 711 711 617 653 113 38 71 710 711 712 749 721 786 787 38 71 66 678 712 685 102 71 66 742 711
653 998 719 66 102 175 742 711 711 712 682 653 38 103 710 711 711 716 681 818 819 38 81 608 710 711 617 685 47 721 66 710
712 653 66 66 66 165 998 742 647 711 712 717 46 3 742 647 711 711 648 653 721 721 103 998 710 711 718 749 35 66 721 710
711 617 653 66 165 3 66 14 742 647 711 681 66 165 165 165 742 647 718 749 786 787 165 3 710 718 749 66 721 786 787 710
711 718 749 66 786 787 70 38 71 742 647 712 653 66 66 66 66 646 681 165 818 819 66 608 710 717 721 66 721 818 819 742
718 749 165 721 818 819 114 38 38 998 710 711 712 653 3 3 66 742 719 786 787 721 3 678 711 617 685 35 721 66 721 646
717 165 37 786 787 38 71 721 81 140 742 647 711 617 653 66 66 66 66 818 819 721 165 710 711 718 717 35 66 35 35 710
617 653 3 818 819 102 81 721 38 38 109 742 711 712 717 37 37 66 721 721 721 70 71 710 718 682 749 14 66 35 35 710
648 682 653 37 165 44 38 82 786 787 721 66 711 711 617 653 66 66 721 721 70 38 81 710 712 682 685 113 807 808 809 710
718 750 749 165 3 721 38 114 818 819 721 646 711 711 648 682 653 66 66 37 102 38 81 710 711 712 717 113 871 872 873 710
749 998 37 721 786 787 38 77 721 998 646 711 711 711 712 682 717 66 66 69 66 102 38 742 711 711 617 685 38 81 66 710
617 653 37 721 818 819 38 71 678 711 711 711 711 711 711 617 717 100 69 66 786 787 46 69 742 711 718 749 113 38 71 646
648 717 100 721 721 721 38 38 742 711 711 711 711 711 711 648 717 164 66 721 818 819 100 69 66 710 717 66 102 38 608 710
718 717 3 3 70 82 38 103 678 711 711 711 711 711 711 648 682 653 66 721 721 164 164 164 66 742 749 66 66 46 646 711
712 717 69 44 868 103 47 69 710 711 711 711 711 711 711 718 715 617 653 3 3 3 69 164 66 66 786 787 721 35 710 711
711 712 653 3 113 71 69 3 742 743 647 711 711 711 711 712 619 718 682 653 164 174 82 71 66 66 818 819 721 35 710 711
711 711 617 653 102 38 71 3 998 608 742 647 647 711 743 711 712 682 682 717 164 69 102 38 71 66 35 35 66 646 711 711
711 711 718 682 653 102 103 3 69 100 998 66 742 647 647 647 711 712 682 717 608 164 164 102 103 164 608 646 716 711 711 711
711 718 715 716 617 653 69 721 66 66 66 66 66 66 66 742 711 711 712 715 716 716 716 716 716 716 716 711 711 711 711 711
