FE5 - Castle v2 (Blue)
23 16
323 398 398 398 398 399 1005 1006 1006 1006 396 398 398 398 398 329
362 781 718 822 717 814 1006 1006 1006 1006 814 718 822 717 814 362
362 749 814 720 783 750 1006 1006 1006 1006 750 814 720 783 750 362
362 1005 750 814 750 1006 1006 1006 1006 1006 1006 750 814 750 1006 362
387 329 813 750 814 323 398 398 398 398 329 813 750 814 323 393
466 362 749 1006 1006 362 717 782 556 782 362 1005 1006 750 362 466
814 362 749 1006 1006 362 813 750 814 750 362 1005 1006 750 362 781
750 362 749 1006 1006 362 749 814 750 814 362 1005 1006 750 362 749
750 362 749 1006 1006 387 398 398 329 1005 394 1005 1006 750 362 749
814 362 749 1006 1006 974 974 974 362 1005 974 1006 1006 750 362 813
814 362 749 1006 1006 1006 1006 1006 362 1005 1006 1006 1006 750 362 813
750 362 749 1006 1006 323 399 1006 387 398 329 1005 1006 750 362 749
750 362 749 1006 1006 362 717 814 718 556 362 1005 1006 750 362 749
814 362 749 1006 1006 362 813 750 814 718 362 1005 1006 750 362 813
814 362 749 1006 1006 362 749 814 750 814 362 1005 1006 750 362 813
323 393 749 1006 1006 387 398 398 398 398 393 1005 1006 750 387 329
362 781 750 1006 1006 974 982 983 983 984 974 1006 1006 750 814 362
362 749 822 749 1006 1006 982 983 983 984 1006 1006 750 822 749 362
362 813 720 783 750 1006 982 983 983 984 1006 750 814 720 783 362
387 398 398 398 329 1005 982 983 556 984 1006 323 398 398 398 393
640 641 641 642 362 1005 1014 1015 1015 1016 1006 362 640 641 641 642
782 718 718 782 362 822 1005 1006 1006 1006 822 362 781 718 718 782
750 814 814 750 387 398 398 398 398 398 398 393 749 814 814 750
