FE5 - Castle v2 (Blue)
24 24
323 398 398 398 398 398 324 399 877 878 878 396 324 398 398 398 398 324 399 982 983 396 398 329
362 845 982 983 984 846 394 781 814 814 814 782 394 781 782 782 782 362 845 982 983 984 846 362
362 877 982 556 980 878 878 814 814 556 813 814 814 814 814 556 813 362 877 982 556 980 878 362
362 877 982 556 980 878 878 814 814 814 814 814 814 814 814 814 814 362 877 982 556 980 878 362
362 877 982 556 980 878 330 877 878 878 878 878 330 877 878 878 878 362 877 982 556 980 878 362
362 877 982 556 980 878 355 399 877 878 396 398 356 399 877 878 396 361 877 982 556 980 878 362
362 877 982 556 980 878 362 877 814 814 782 878 362 781 814 814 782 394 877 982 556 980 878 362
362 877 1014 1015 1016 878 362 877 814 556 813 878 362 813 814 556 813 878 878 1014 1015 1016 878 362
362 877 878 878 878 878 362 877 814 814 814 878 362 813 814 814 814 330 877 878 878 878 878 362
355 399 878 878 396 398 356 399 877 878 396 398 356 398 398 398 398 356 398 398 398 398 398 361
362 845 814 814 782 846 362 877 878 878 846 846 362 877 846 846 846 394 877 782 782 782 846 362
362 813 814 814 814 814 362 877 814 814 814 814 362 813 814 814 814 878 814 814 814 814 814 362
362 813 814 556 813 814 362 877 814 556 813 814 362 813 814 556 813 878 814 814 556 814 814 362
362 877 814 814 814 878 362 877 814 814 814 814 362 813 814 814 814 330 813 814 814 814 814 362
355 399 878 878 396 398 356 399 878 878 396 398 356 399 878 878 396 356 399 877 878 396 398 361
362 845 878 878 846 846 362 717 814 814 814 814 394 717 814 814 814 362 877 878 878 878 878 362
362 877 878 878 878 878 362 749 814 814 814 814 718 814 814 814 814 362 877 878 878 878 878 362
362 877 878 878 878 878 362 749 814 814 814 814 330 749 814 814 814 362 877 878 878 878 878 362
355 399 877 878 396 398 388 398 398 398 398 398 388 398 398 398 398 388 399 877 878 396 398 361
394 877 878 878 846 846 846 846 846 846 846 846 846 846 846 846 846 846 846 878 878 846 846 362
846 814 814 814 814 814 878 878 878 878 878 878 878 878 878 878 878 878 878 814 814 814 814 362
878 814 814 814 814 814 878 878 878 878 878 878 878 878 878 878 878 878 878 814 814 814 814 362
330 814 814 814 814 814 878 878 878 878 878 878 878 878 878 878 878 878 878 814 814 814 814 362
387 398 398 398 398 398 398 398 398 398 398 398 398 398 398 398 398 398 398 398 398 398 398 393
