FE5 - Castle v2 (Blue)
28 21
814 814 750 750 822 823 822 750 750 814 814 362 516 516 516 516 362 1005 1006 1006 1006
814 814 750 750 720 855 720 750 750 814 814 362 580 580 580 580 362 1005 556 1006 556
398 398 398 339 749 750 750 339 395 398 398 393 1 2 2 2 362 1005 1006 1006 1006
641 641 642 371 425 458 459 371 640 641 641 642 33 35 35 35 339 401 339 395 398
2 2 2 435 425 458 459 435 1 2 2 503 600 600 600 505 371 460 371 640 641
505 35 35 2 535 536 537 2 35 35 503 569 35 35 35 534 435 492 435 1 503
567 600 600 600 536 536 568 600 600 600 569 35 35 35 35 567 504 536 600 600 569
1022 1022 959 33 535 537 35 957 1022 1022 1022 1022 1022 1022 1022 830 534 829 1022 1022 1022
506 506 1021 830 432 433 829 1023 35 503 504 600 600 600 600 600 536 505 506 506 96
35 506 506 109 535 537 35 506 35 535 569 35 35 902 903 904 535 537 506 506 506
506 506 109 599 536 537 506 506 503 537 35 506 502 934 935 936 567 537 902 903 904
35 963 964 965 567 536 504 504 536 225 35 173 224 504 568 601 35 534 934 935 936
506 995 996 997 506 535 536 536 537 506 35 35 192 537 35 35 35 535 504 537 506
35 503 225 506 35 535 536 536 537 173 35 503 536 536 504 504 504 536 536 536 505
503 536 193 35 503 568 568 568 537 35 506 535 966 967 840 961 968 628 960 961 968
536 536 536 504 569 896 897 898 567 505 173 535 998 999 872 993 1000 628 992 993 1000
536 536 536 537 506 928 929 930 506 534 506 224 536 536 536 536 536 536 536 536 536
960 961 968 537 506 503 536 505 506 534 173 192 960 961 841 967 968 628 960 961 968
992 993 1000 536 504 568 568 568 504 536 600 536 992 993 873 999 1000 628 992 993 1000
568 568 536 568 537 506 506 65 535 225 35 535 536 536 536 536 536 536 536 536 536
65 35 534 506 210 239 96 506 566 506 192 536 966 967 840 961 968 628 960 961 968
97 503 537 506 224 193 35 506 506 97 535 536 998 999 872 993 1000 628 992 993 1000
503 536 536 505 506 210 239 96 506 503 536 536 536 536 536 536 536 536 536 536 536
960 961 968 628 193 224 193 35 503 536 536 536 960 961 841 967 968 628 966 967 968
992 993 1000 628 537 35 534 35 535 536 536 536 992 993 873 999 1000 628 998 999 1000
568 568 568 536 536 504 536 504 536 536 536 536 536 536 536 536 536 536 536 536 536
398 398 339 33 567 536 536 536 536 536 569 35 339 395 398 398 398 398 398 398 398
516 516 371 339 33 567 568 568 568 569 35 339 371 516 516 516 516 516 516 516 516
