FE5 - Fields (Day)
22 25
38 169 102 105 171 102 111 38 38 105 171 102 103 130 66 66 172 173 721 721 66 66 66 102 103
38 109 759 756 756 760 66 102 103 131 721 66 70 71 70 79 71 721 66 70 71 140 141 66 67
105 131 915 916 853 724 760 721 66 70 625 458 458 458 458 689 480 481 482 482 482 482 482 483 999
175 759 947 948 885 724 790 721 66 142 657 486 519 519 519 657 512 513 514 514 514 514 514 515 999
175 791 763 724 724 790 721 66 70 38 657 518 454 454 454 453 512 513 514 514 514 514 514 515 999
73 721 66 791 790 130 70 79 625 458 523 518 454 454 454 485 512 545 546 546 546 546 546 515 999
38 71 131 138 78 72 38 625 523 486 519 454 658 518 454 655 576 577 448 517 517 448 577 578 999
38 169 138 625 458 458 458 523 486 454 454 454 657 518 454 657 495 493 497 421 421 497 495 496 999
143 67 136 657 486 519 519 519 454 454 454 620 624 518 454 657 1000 1001 66 791 792 66 66 35 66
38 137 168 657 518 454 454 454 454 454 620 588 624 518 454 522 626 135 721 66 66 721 721 66 66
38 103 67 657 518 454 454 457 458 458 555 555 656 518 454 519 522 458 689 458 458 458 458 458 626
103 67 136 657 518 454 454 519 519 519 519 519 657 518 454 454 519 519 554 486 33 486 519 519 657
71 98 168 657 518 454 454 454 454 454 454 454 522 626 518 454 454 454 519 454 519 454 33 518 657
38 71 67 657 518 454 454 454 454 454 454 454 519 657 518 454 454 454 658 518 454 454 519 454 657
38 103 136 448 461 461 461 461 448 518 454 454 448 463 461 461 461 461 463 461 461 461 461 461 491
103 67 168 497 495 493 493 493 497 421 421 421 497 495 493 493 493 493 493 493 493 493 493 493 496
71 99 67 46 102 105 721 66 46 421 421 421 1000 66 721 66 102 103 721 721 721 66 66 102 38
103 162 67 131 67 131 67 162 67 758 724 790 721 66 721 66 66 67 759 756 760 66 67 67 142
66 99 67 99 67 70 79 71 67 791 724 792 67 67 67 66 66 759 915 916 853 760 66 66 102
73 721 66 131 99 102 38 143 721 66 789 67 70 71 99 98 67 758 947 948 885 790 721 66 67
38 73 70 79 71 70 38 38 71 66 789 67 142 38 79 71 99 791 788 788 788 792 66 67 70
38 38 38 38 38 38 38 38 38 77 789 76 38 38 38 38 79 71 70 79 71 67 70 79 38
