FE5 - Fields (Day)
24 26
721 789 721 789 721 761 764 792 657 421 421 582 549 582 421 421 657 999 791 757 760 721 789 132 791 756
761 792 172 791 764 792 140 72 657 423 422 422 581 423 422 422 657 999 134 135 791 764 792 66 132 788
792 132 480 481 482 482 482 483 657 487 455 455 455 455 455 455 657 480 481 482 482 482 483 999 132 99
132 721 512 513 514 514 514 483 456 487 455 455 455 455 455 455 657 512 513 514 514 514 483 999 721 759
760 721 512 545 546 546 546 483 488 487 455 455 455 455 455 455 453 512 545 546 546 546 483 999 132 791
792 102 576 577 577 577 577 578 658 487 455 455 455 455 455 455 485 576 577 577 577 577 578 999 132 72
480 481 482 482 483 625 484 458 555 458 458 459 487 455 457 458 555 458 458 484 626 480 481 482 482 483
512 513 514 514 483 657 423 422 422 422 422 422 455 455 422 422 422 422 422 422 657 512 513 514 514 483
512 513 514 514 483 456 487 455 455 455 455 455 455 455 455 455 455 455 455 455 657 512 513 514 514 483
512 545 546 546 483 488 487 455 625 461 461 448 487 455 448 461 461 626 487 455 453 512 545 546 546 483
576 577 577 577 578 658 487 455 657 495 493 497 421 421 497 495 493 657 487 455 485 576 577 577 577 578
512 481 482 482 483 657 487 455 657 999 759 757 724 724 757 760 72 657 487 455 657 512 481 482 482 483
512 513 514 514 483 657 487 455 657 999 789 131 791 792 131 789 102 657 487 455 657 512 513 514 514 483
512 513 514 514 483 456 487 455 657 999 791 757 756 756 757 792 72 657 487 455 657 512 513 514 514 483
512 513 514 514 483 488 487 455 522 458 458 626 725 796 625 458 458 523 487 455 453 512 513 514 514 483
512 513 514 514 483 657 487 455 455 455 455 657 725 796 657 487 455 455 455 455 485 512 513 514 514 483
512 545 546 546 483 657 487 455 455 455 455 657 725 796 657 487 455 455 455 455 657 512 545 546 546 483
448 577 577 480 481 482 482 482 483 448 487 448 725 796 448 487 448 480 481 482 482 482 483 577 577 448
495 493 493 512 513 514 514 514 483 497 421 497 725 796 497 421 497 512 513 514 514 514 483 495 493 497
102 103 166 512 513 514 514 514 483 999 789 110 795 796 110 789 102 512 513 514 514 514 483 999 102 103
760 66 70 512 513 514 514 514 483 999 791 756 724 724 756 724 760 512 513 514 514 514 483 999 162 759
724 760 102 512 545 546 546 546 483 999 99 795 724 788 724 724 792 512 545 546 546 546 483 999 759 724
724 792 70 448 577 577 577 577 448 999 759 724 792 99 791 792 76 448 577 577 577 577 448 999 791 724
792 70 38 497 495 493 493 493 497 999 791 792 140 72 71 132 136 497 495 493 493 493 497 999 131 791
