FE5 - Fields (Day)
17 30
711 718 682 619 711 711 617 715 780 718 715 711 649 717 782 131 67 600 66 631 598 70 38 38 103 46 807 808 809 782
711 617 682 682 619 711 718 779 648 749 742 775 777 749 643 99 99 599 570 605 782 102 38 81 804 66 839 840 841 782
711 648 682 682 715 713 682 750 719 782 807 808 809 66 100 99 164 14 66 600 782 131 102 103 361 782 871 872 873 66
647 648 682 717 742 648 717 782 782 66 839 840 841 804 675 99 76 38 71 2 14 782 14 66 66 66 208 177 145 199
742 777 750 749 608 777 749 99 204 199 871 872 873 67 643 163 70 38 80 600 112 82 38 71 676 773 505 540 231 230
608 782 782 66 782 67 99 131 264 805 337 293 131 99 677 499 142 167 107 696 102 103 102 103 131 99 230 401 145 199
140 15 857 858 859 99 198 145 176 771 672 773 675 771 782 70 38 71 99 599 34 570 630 198 275 269 198 401 401 401
113 103 889 890 891 98 238 230 231 70 82 79 71 70 71 102 38 143 67 70 103 388 2 231 230 401 401 305 177 231
102 71 921 922 923 14 99 99 99 112 38 38 38 38 103 163 168 103 99 102 71 99 600 131 99 230 231 66 66 131
70 38 71 70 82 38 79 15 79 103 102 38 114 38 71 100 70 80 782 70 103 131 564 99 162 57 52 117 118 164
38 38 114 38 38 38 38 143 173 130 70 38 45 166 38 82 167 107 131 46 131 66 636 54 57 244 245 244 245 54
102 103 70 38 38 103 102 103 99 67 102 103 99 70 114 103 782 782 208 199 116 53 212 212 244 213 213 213 213 245
100 162 102 38 38 71 131 99 131 99 640 99 76 81 782 164 198 199 206 144 215 212 244 213 213 213 213 213 213 213
57 52 118 46 102 103 99 807 808 809 672 773 99 102 71 164 144 401 401 401 247 244 213 213 277 276 277 276 213 277
125 244 245 54 119 99 131 839 840 841 164 900 676 44 38 77 230 316 316 247 244 213 213 277 283 212 216 217 212 214
244 213 213 245 124 131 66 871 872 873 206 361 260 836 113 77 53 347 350 244 213 213 277 216 304 217 54 57 26 869
213 213 213 213 245 56 66 132 144 145 177 145 231 70 38 137 25 212 244 213 213 277 216 235 868 236 314 212 52 230
