FE5 - Fields (Day)
22 20
618 682 715 711 716 718 682 750 749 807 808 809 720 742 647 716 617 619 711 648
682 715 712 619 711 617 717 782 782 839 840 841 100 65 742 647 712 715 711 648
715 649 718 715 711 648 717 836 782 871 872 873 70 71 65 742 647 716 711 718
715 648 749 742 775 777 749 238 99 208 176 174 38 103 100 65 742 775 647 617
868 719 782 163 782 782 782 100 782 782 144 199 46 782 70 80 782 65 742 777
99 66 163 782 66 782 782 782 66 782 230 177 209 70 38 81 141 782 163 65
70 782 71 163 163 782 782 66 782 99 782 708 708 102 114 114 38 82 71 70
102 38 103 70 782 77 66 782 782 708 614 716 648 685 708 709 102 114 868 113
82 38 82 38 38 782 782 708 614 648 619 711 718 715 748 718 966 868 113 103
113 38 103 46 102 137 678 648 619 718 715 711 617 779 648 749 608 70 38 71
38 38 82 71 70 103 710 648 682 750 750 619 648 750 719 782 163 102 38 38
103 102 103 102 38 45 710 718 717 608 678 750 719 609 610 70 71 70 38 114
71 957 958 959 47 678 748 682 749 67 609 610 609 610 44 38 103 102 103 100
81 989 990 991 163 710 718 717 100 99 163 14 99 70 82 38 82 71 70 71
103 1021 1017 1023 66 710 617 717 608 70 82 38 45 113 38 167 46 166 38 38
71 70 82 82 45 742 456 749 782 113 38 38 137 102 114 45 782 782 102 114
102 38 38 38 71 65 488 163 70 38 38 114 103 67 163 782 786 787 608 608
868 102 111 38 143 66 658 66 102 38 103 163 67 99 786 787 818 819 614 617
685 708 709 102 103 614 648 685 163 46 131 67 99 162 818 819 782 614 711 648
715 716 648 685 614 711 718 717 804 99 163 99 131 163 782 608 614 711 711 718
716 711 648 715 711 711 712 682 685 782 99 804 804 782 614 617 619 711 718 682
711 711 718 779 711 711 711 716 617 685 608 609 610 614 711 648 715 718 682 682
