FE5 - Fields (Day)
21 15
38 81 102 103 608 742 775 775 775 647 711 712 682 619 617
166 103 782 67 131 67 67 67 608 742 647 711 712 715 718
45 782 70 77 857 858 859 67 162 782 742 647 711 716 716
14 132 168 109 889 890 891 99 741 673 65 742 647 711 711
38 71 72 71 921 922 923 14 132 782 609 610 742 775 647
38 38 38 81 70 82 82 38 82 77 783 66 65 608 710
102 103 102 114 103 102 38 38 105 66 14 99 66 66 710
57 54 67 807 808 809 168 38 109 162 102 79 71 608 710
213 22 99 839 840 841 108 103 675 782 782 113 103 782 742
26 782 131 871 872 873 67 771 499 66 70 103 782 782 65
782 672 773 67 230 390 99 67 782 70 38 82 71 782 164
56 782 170 99 55 56 55 52 131 102 103 168 38 82 71
245 52 119 55 244 245 244 124 132 70 71 106 104 38 169
213 213 245 244 213 277 276 22 76 38 114 82 82 105 107
277 22 27 84 85 86 26 132 67 102 109 102 111 109 131
26 70 71 76 82 82 109 260 390 133 782 67 804 67 67
98 142 103 772 102 103 208 333 782 804 131 208 231 99 786
82 103 99 198 506 99 704 366 209 366 209 807 808 809 818
103 260 337 177 436 540 199 368 273 176 99 839 840 841 67
208 333 677 782 230 176 230 231 296 805 199 871 872 873 99
782 366 782 782 198 177 199 67 234 365 230 273 231 67 131
