FE5 - Fields (Day)
19 19
66 66 782 66 66 782 782 782 742 712 682 682 682 749 782 133 102 103 102
782 66 198 199 66 66 900 782 608 710 617 682 717 608 67 957 958 959 70
199 198 807 808 809 208 333 133 65 710 716 617 682 685 99 989 990 991 102
230 295 839 840 841 208 333 609 610 710 711 648 682 717 782 1021 895 1023 70
804 132 871 872 873 206 331 708 708 710 711 718 682 717 66 44 38 82 38
673 132 198 177 337 231 678 716 716 711 713 682 682 717 672 773 102 38 38
720 130 144 209 674 772 742 775 711 711 718 682 682 717 782 782 768 102 38
71 198 401 199 163 804 804 782 742 711 617 682 682 717 608 782 782 70 38
137 230 231 144 145 231 99 782 608 710 712 682 682 749 608 782 67 102 114
38 45 332 176 238 67 66 836 782 710 711 617 682 685 782 70 82 71 70
38 82 71 144 145 199 198 231 709 710 711 718 682 717 66 102 38 103 142
38 38 103 144 231 230 231 678 718 619 713 682 715 617 685 70 81 206 102
38 103 198 176 198 199 67 742 712 715 718 750 715 648 717 102 103 366 209
38 82 230 401 176 238 99 66 742 649 717 782 742 777 749 208 273 369 782
102 114 45 144 231 782 673 672 773 777 749 782 782 163 838 966 270 231 782
199 198 145 401 506 505 199 782 782 70 79 82 71 202 207 869 401 209 709
230 231 230 869 401 401 176 206 66 102 114 103 46 264 401 177 869 614 718
782 782 643 144 401 401 401 401 145 199 198 199 66 230 176 67 678 718 682
782 772 675 230 401 401 231 230 177 305 231 230 263 262 401 199 710 617 682
