FE5 - Castle v2 (Blue)
25 23
175 175 175 175 175 323 398 398 398 589 398 398 398 329 175 175 175 175 175 175 175 175 175
175 175 175 175 175 362 845 822 982 855 984 822 845 362 175 175 175 175 175 175 175 175 175
175 175 175 175 175 362 877 822 1014 1015 1016 822 877 362 175 175 323 398 398 398 398 398 329
323 398 398 398 398 393 877 848 878 878 878 848 878 362 175 175 362 973 974 556 973 974 362
362 845 846 846 846 846 878 878 878 878 878 878 878 362 175 175 362 556 1005 1006 1006 1006 362
362 877 878 878 878 878 878 878 878 878 878 878 878 362 224 175 362 973 1006 556 330 1005 362
362 877 878 878 878 878 320 321 326 398 398 398 398 393 33 224 355 398 398 398 393 1005 362
355 399 877 878 396 398 389 385 335 641 641 641 641 642 33 35 362 973 974 974 974 1006 362
362 845 878 878 846 846 846 846 362 33 156 220 157 35 35 35 394 1005 1006 330 1005 1006 362
362 877 878 878 878 330 877 878 394 33 188 252 189 35 209 35 524 425 459 362 1005 1006 362
362 877 878 878 878 362 425 459 524 33 35 35 35 192 271 35 35 35 35 362 1005 1006 394
387 398 398 325 321 367 33 35 35 35 35 192 273 264 265 323 398 398 398 393 1005 1006 974
640 641 641 331 385 390 398 398 398 398 329 175 175 175 175 362 973 974 974 974 1006 1006 330
175 175 175 362 973 974 974 974 974 974 362 175 175 175 175 394 1005 1006 330 1005 1006 1006 362
175 175 175 362 1005 1006 1006 330 1005 1006 394 175 175 175 175 524 425 459 362 1005 1006 1006 362
175 175 175 362 1005 1006 1006 362 425 459 524 175 175 175 175 175 175 175 362 1005 1006 1006 362
175 175 175 362 1005 1006 1006 362 175 175 175 175 175 175 175 175 556 175 362 1005 1006 556 362
175 175 175 362 1005 1006 1006 387 398 398 398 398 398 398 398 329 175 175 362 1005 1006 1006 362
175 175 175 362 1005 1006 1006 974 974 974 974 974 974 974 974 387 398 398 393 1005 1006 1006 362
175 175 175 362 1005 1006 1006 1006 1006 1006 1006 1006 1006 1006 1006 974 974 974 974 1006 1006 1006 362
175 175 175 387 398 398 398 398 398 398 329 1005 1006 1006 1006 1006 1006 1006 1006 1006 1006 1006 362
175 175 175 640 641 641 641 641 641 641 394 1005 1006 1006 396 398 398 398 329 1005 1006 1006 362
175 175 175 175 175 175 175 175 175 175 524 425 458 459 640 641 641 641 387 398 398 398 393
175 175 175 175 175 175 175 175 175 175 175 175 175 175 175 175 175 175 640 641 641 641 642
175 175 175 175 175 175 175 175 175 175 175 175 175 175 175 175 175 175 175 175 175 175 175
