FE5 - Fields (Green)
23 24
721 772 772 772 66 721 721 657 454 454 454 454 454 454 454 454 554 162 162 721 162 162 162 66
721 66 66 66 721 721 66 657 317 454 454 454 454 454 454 454 286 174 71 66 66 721 66 66
3 66 66 37 70 71 37 554 162 317 454 454 454 454 454 454 658 37 113 71 772 772 66 66
786 787 721 37 102 721 721 162 162 285 454 454 454 454 454 454 554 37 102 38 71 66 162 721
818 819 721 721 66 66 721 162 285 454 454 317 454 454 454 318 66 721 66 110 102 71 66 66
786 787 66 721 66 66 162 162 457 458 459 71 317 457 459 162 162 66 721 66 174 81 721 66
818 819 66 66 721 721 66 162 70 38 38 103 66 37 37 37 37 162 162 66 70 38 82 71
721 66 66 162 66 66 70 82 38 103 110 721 37 721 66 66 786 787 66 721 110 102 114 38
3 162 162 3 66 721 142 103 110 721 37 66 3 3 721 66 818 819 66 162 721 162 162 114
162 162 772 772 721 721 102 175 162 66 721 37 721 3 66 786 787 66 162 721 66 721 721 66
721 3 772 772 772 721 66 66 721 162 721 3 66 66 3 818 819 162 66 66 66 721 786 787
881 882 3 3 3 786 787 66 721 66 162 3 66 3 721 3 162 3 3 721 3 3 818 819
945 946 66 37 70 818 819 721 786 787 721 721 721 721 3 66 162 66 66 721 786 787 880 881
721 66 3 70 721 721 721 78 818 819 66 162 102 38 786 787 66 721 721 38 818 819 912 913
721 721 721 721 38 721 786 787 71 3 66 66 37 102 818 819 880 881 882 38 103 102 944 945
162 721 3 721 38 38 818 819 103 66 66 66 66 174 38 721 944 945 946 38 71 70 38 721
71 78 721 786 787 111 103 721 721 66 721 721 66 3 110 66 66 721 110 110 110 110 110 110
102 38 175 818 819 37 721 66 66 721 66 66 3 15 162 66 66 162 66 66 721 721 66 70
174 103 66 66 721 721 721 66 66 721 66 66 70 81 721 71 162 37 70 880 881 881 882 110
772 772 786 787 66 66 66 721 66 66 66 3 113 103 721 721 162 162 102 944 945 945 946 66
786 787 818 819 162 162 721 162 162 162 162 70 81 162 37 66 721 66 66 66 786 787 66 66
818 819 66 3 721 721 66 66 37 112 82 38 103 37 66 66 66 721 66 66 818 819 772 772
772 772 772 3 786 787 3 3 112 82 38 103 66 112 71 66 66 786 787 786 787 37 66 66
