FE5 - Fields (Green)
16 23
213 213 277 84 86 276 213 277 212 84 86 276 213 277 212 88 276 213 213 213 277 276 213
213 277 20 3 3 21 88 212 20 740 738 21 212 88 20 99 21 276 213 277 84 86 276
277 20 70 80 721 3 66 221 218 70 71 99 120 66 721 69 66 221 277 20 66 66 21
220 3 102 82 80 162 3 2 112 38 81 721 69 70 80 3 53 212 20 70 71 15 70
212 52 3 721 162 162 219 220 66 102 103 112 868 103 3 69 221 220 69 102 38 114 38
245 212 52 3 3 53 117 212 52 3 3 3 66 69 53 117 212 220 69 69 110 66 102
213 245 212 4 117 212 244 245 212 117 4 117 52 53 212 212 212 245 218 772 772 15 78
213 213 212 36 212 244 213 213 277 212 36 212 212 212 212 212 212 20 140 141 70 114 103
213 213 212 36 212 276 213 277 84 85 68 85 86 212 212 20 120 69 70 38 103 721 772
213 277 212 68 87 212 277 220 66 69 15 162 162 21 20 3 162 112 114 103 772 772 772
277 212 20 15 66 21 212 212 52 162 102 71 3 69 69 772 772 3 721 140 141 66 66
212 20 162 113 71 721 21 212 212 218 70 103 721 69 66 3 69 868 70 103 721 66 66
20 69 3 113 103 107 99 21 20 112 81 3 772 772 772 721 721 102 81 721 786 787 66
162 69 112 81 721 66 772 772 162 70 38 80 3 3 15 3 3 70 38 80 818 819 3
52 66 3 102 82 868 71 70 82 38 103 69 721 70 38 71 162 47 102 71 75 772 772
212 52 162 162 110 113 38 38 103 47 162 162 162 47 102 81 15 66 66 102 175 69 721
